MONTH,FILE_NAME,HARD_CODE_SECR,EMPT_PASS,HTTP_USAG,BIND_USAG,SUSP_COMM,INTE_CHCK,TOTAL
2019-03-09 02:03:14.955676, /home/brokenquark/repo-ansi/2015-Middleware-Keynote@demo-ansible/playbooks/post_setup.yml,0,0,0,0,1,0,1
2019-03-09 02:03:14.968480, /home/brokenquark/repo-ansi/2015-Middleware-Keynote@demo-ansible/playbooks/vars.yml,6,0,0,0,0,0,6
2019-03-09 02:03:15.002094, /home/brokenquark/repo-ansi/2015-Middleware-Keynote@demo-ansible/playbooks/tasks/registry_wait.yml,0,0,0,0,1,0,1
2019-03-09 02:03:26.158249, /home/brokenquark/repo-ansi/CentOS-PaaS-SIG@aos-ci/playbooks/roles/rdgo-system/tasks/main.yml,0,0,0,0,1,3,4
2019-03-09 02:03:26.165940, /home/brokenquark/repo-ansi/CentOS-PaaS-SIG@aos-ci/playbooks/roles/rpmbuild-system/tasks/main.yml,0,0,0,0,0,1,1
2019-03-09 02:03:26.712459, /home/brokenquark/repo-ansi/CentOS-PaaS-SIG@ci-pipeline/playbooks/roles/rdgo-system/tasks/main.yml,0,0,0,0,1,3,4
2019-03-09 02:03:26.719681, /home/brokenquark/repo-ansi/CentOS-PaaS-SIG@ci-pipeline/playbooks/roles/rpmbuild-system/tasks/main.yml,0,0,0,0,0,1,1
2019-03-09 02:03:27.846487, /home/brokenquark/repo-ansi/CentOS-PaaS-SIG@linch-pin/dev_setup/playbooks/group_vars/all/global.yml,4,0,1,0,0,1,6
2019-03-09 02:03:27.856009, /home/brokenquark/repo-ansi/CentOS-PaaS-SIG@linch-pin/dev_setup/playbooks/roles/prereqs/tasks/install_virtual_reqs.yml,0,0,0,0,0,1,1
2019-03-09 02:03:27.867084, /home/brokenquark/repo-ansi/CentOS-PaaS-SIG@linch-pin/dev_setup/playbooks/roles/prereqs/tasks/install_kvm_plugin.yml,1,0,0,0,0,0,1
2019-03-09 02:03:27.869199, /home/brokenquark/repo-ansi/CentOS-PaaS-SIG@linch-pin/dev_setup/playbooks/roles/minishift/defaults/main.yml,0,0,1,0,0,1,2
2019-03-09 02:03:27.892410, /home/brokenquark/repo-ansi/CentOS-PaaS-SIG@linch-pin/dev_setup/playbooks/roles/pipeline/defaults/main.yml,4,0,1,0,0,1,6
2019-03-09 02:03:29.541328, /home/brokenquark/repo-ansi/CentOS-PaaS-SIG@linchpin/dev_setup/playbooks/group_vars/all/global.yml,4,0,1,0,0,1,6
2019-03-09 02:03:29.549090, /home/brokenquark/repo-ansi/CentOS-PaaS-SIG@linchpin/dev_setup/playbooks/roles/prereqs/tasks/install_virtual_reqs.yml,0,0,0,0,0,1,1
2019-03-09 02:03:29.559199, /home/brokenquark/repo-ansi/CentOS-PaaS-SIG@linchpin/dev_setup/playbooks/roles/prereqs/tasks/install_kvm_plugin.yml,1,0,0,0,0,0,1
2019-03-09 02:03:29.561125, /home/brokenquark/repo-ansi/CentOS-PaaS-SIG@linchpin/dev_setup/playbooks/roles/minishift/defaults/main.yml,0,0,1,0,0,1,2
2019-03-09 02:03:29.582301, /home/brokenquark/repo-ansi/CentOS-PaaS-SIG@linchpin/dev_setup/playbooks/roles/pipeline/defaults/main.yml,4,0,1,0,0,1,6
2019-03-09 02:03:30.565683, /home/brokenquark/repo-ansi/CiscoCloud@mantl/playbooks/host-connectivity.yml,0,0,0,0,1,0,1
2019-03-09 02:03:30.637260, /home/brokenquark/repo-ansi/CiscoCloud@mantl/playbooks/upgrade-1.0.3.yml,1,0,0,0,0,0,1
2019-03-09 02:03:31.429929, /home/brokenquark/repo-ansi/CiscoCloud@microservices-infrastructure/playbooks/host-connectivity.yml,0,0,0,0,1,0,1
2019-03-09 02:03:31.488005, /home/brokenquark/repo-ansi/CiscoCloud@microservices-infrastructure/playbooks/upgrade-1.0.3.yml,1,0,0,0,0,0,1
2019-03-09 02:03:32.585162, /home/brokenquark/repo-ansi/CyberAnalyticDevTeam@SimpleRock/playbooks/setup-deploy-host.yml,6,0,0,0,0,1,7
2019-03-09 02:03:32.599608, /home/brokenquark/repo-ansi/CyberAnalyticDevTeam@SimpleRock/playbooks/generate-defaults.yml,2,0,0,0,0,0,2
2019-03-09 02:03:32.619760, /home/brokenquark/repo-ansi/CyberAnalyticDevTeam@SimpleRock/playbooks/group_vars/all.yml,9,0,1,1,0,0,11
2019-03-09 02:04:14.914387, /home/brokenquark/repo-ansi/Katello@katello-deploy/playbooks/luna_provisioning.yml,1,0,0,0,0,0,1
2019-03-09 02:04:14.936540, /home/brokenquark/repo-ansi/Katello@katello-deploy/playbooks/runcible.yml,1,0,1,0,0,1,3
2019-03-09 02:04:16.202871, /home/brokenquark/repo-ansi/LearnEra@LearnEra-Configuration/playbooks/roles/jenkins_master/defaults/main.yml,1,0,1,0,0,0,2
2019-03-09 02:04:16.220648, /home/brokenquark/repo-ansi/LearnEra@LearnEra-Configuration/playbooks/roles/jenkins_master/tasks/main.yml,0,0,0,0,4,0,4
2019-03-09 02:04:16.234244, /home/brokenquark/repo-ansi/LearnEra@LearnEra-Configuration/playbooks/roles/common/defaults/main.yml,11,1,1,0,0,0,13
2019-03-09 02:04:16.247485, /home/brokenquark/repo-ansi/LearnEra@LearnEra-Configuration/playbooks/roles/common/tasks/main.yml,0,0,0,0,1,0,1
2019-03-09 02:04:16.272314, /home/brokenquark/repo-ansi/LearnEra@LearnEra-Configuration/playbooks/roles/gerrit/defaults/main.yml,1,0,0,0,0,0,1
2019-03-09 02:04:16.298308, /home/brokenquark/repo-ansi/LearnEra@LearnEra-Configuration/playbooks/roles/xserver/defaults/main.yml,3,0,0,0,0,0,3
2019-03-09 02:04:16.324636, /home/brokenquark/repo-ansi/LearnEra@LearnEra-Configuration/playbooks/roles/test_build_server/defaults/main.yml,1,0,0,0,0,0,1
2019-03-09 02:04:16.333630, /home/brokenquark/repo-ansi/LearnEra@LearnEra-Configuration/playbooks/roles/aws/defaults/main.yml,0,0,1,0,1,1,3
2019-03-09 02:04:16.343992, /home/brokenquark/repo-ansi/LearnEra@LearnEra-Configuration/playbooks/roles/aws/tasks/main.yml,1,0,0,0,0,0,1
2019-03-09 02:04:16.355126, /home/brokenquark/repo-ansi/LearnEra@LearnEra-Configuration/playbooks/roles/forum/defaults/main.yml,3,0,0,1,0,0,4
2019-03-09 02:04:16.393154, /home/brokenquark/repo-ansi/LearnEra@LearnEra-Configuration/playbooks/roles/analytics-api/defaults/main.yml,7,1,0,0,0,0,8
2019-03-09 02:04:16.436197, /home/brokenquark/repo-ansi/LearnEra@LearnEra-Configuration/playbooks/roles/ora/defaults/main.yml,13,0,0,0,0,0,13
2019-03-09 02:04:16.466892, /home/brokenquark/repo-ansi/LearnEra@LearnEra-Configuration/playbooks/roles/redis/defaults/main.yml,1,1,0,0,0,0,2
2019-03-09 02:04:16.474624, /home/brokenquark/repo-ansi/LearnEra@LearnEra-Configuration/playbooks/roles/elasticsearch/defaults/main.yml,1,0,0,0,0,0,1
2019-03-09 02:04:16.507416, /home/brokenquark/repo-ansi/LearnEra@LearnEra-Configuration/playbooks/roles/flower/defaults/main.yml,3,0,0,1,0,0,4
2019-03-09 02:04:16.519312, /home/brokenquark/repo-ansi/LearnEra@LearnEra-Configuration/playbooks/roles/gh_mirror/defaults/main.yml,1,0,0,0,0,0,1
2019-03-09 02:04:16.535012, /home/brokenquark/repo-ansi/LearnEra@LearnEra-Configuration/playbooks/roles/analytics/defaults/main.yml,8,0,0,0,0,0,8
2019-03-09 02:04:16.559161, /home/brokenquark/repo-ansi/LearnEra@LearnEra-Configuration/playbooks/roles/devpi/defaults/main.yml,2,0,0,0,0,0,2
2019-03-09 02:04:16.591904, /home/brokenquark/repo-ansi/LearnEra@LearnEra-Configuration/playbooks/roles/user/defaults/main.yml,0,0,0,0,1,0,1
2019-03-09 02:04:16.621999, /home/brokenquark/repo-ansi/LearnEra@LearnEra-Configuration/playbooks/roles/alton/defaults/main.yml,4,0,0,0,0,0,4
2019-03-09 02:04:16.659172, /home/brokenquark/repo-ansi/LearnEra@LearnEra-Configuration/playbooks/roles/gluster/tasks/main.yml,0,0,0,0,1,0,1
2019-03-09 02:04:16.670250, /home/brokenquark/repo-ansi/LearnEra@LearnEra-Configuration/playbooks/roles/certs/defaults/main.yml,10,0,0,0,0,0,10
2019-03-09 02:04:16.697330, /home/brokenquark/repo-ansi/LearnEra@LearnEra-Configuration/playbooks/roles/demo/defaults/main.yml,6,0,0,0,0,0,6
2019-03-09 02:04:16.707498, /home/brokenquark/repo-ansi/LearnEra@LearnEra-Configuration/playbooks/roles/oraclejdk/defaults/main.yml,0,0,1,0,0,0,1
2019-03-09 02:04:16.719164, /home/brokenquark/repo-ansi/LearnEra@LearnEra-Configuration/playbooks/roles/splunkforwarder/defaults/main.yml,0,1,0,0,0,0,1
2019-03-09 02:04:16.728850, /home/brokenquark/repo-ansi/LearnEra@LearnEra-Configuration/playbooks/roles/splunkforwarder/tasks/main.yml,1,0,0,0,0,0,1
2019-03-09 02:04:16.744908, /home/brokenquark/repo-ansi/LearnEra@LearnEra-Configuration/playbooks/roles/notifier/defaults/main.yml,2,2,0,0,0,0,4
2019-03-09 02:04:16.773303, /home/brokenquark/repo-ansi/LearnEra@LearnEra-Configuration/playbooks/roles/edx_ansible/defaults/main.yml,1,0,0,0,0,0,1
2019-03-09 02:04:16.797189, /home/brokenquark/repo-ansi/LearnEra@LearnEra-Configuration/playbooks/roles/snort/defaults/main.yml,0,0,2,0,0,1,3
2019-03-09 02:04:16.863395, /home/brokenquark/repo-ansi/LearnEra@LearnEra-Configuration/playbooks/roles/s3fs/defaults/main.yml,0,0,1,0,0,0,1
2019-03-09 02:04:16.876050, /home/brokenquark/repo-ansi/LearnEra@LearnEra-Configuration/playbooks/roles/mongo/defaults/main.yml,5,0,1,0,0,0,6
2019-03-09 02:04:16.994755, /home/brokenquark/repo-ansi/LearnEra@LearnEra-Configuration/playbooks/roles/edxapp/defaults/main.yml,94,2,4,0,1,0,101
2019-03-09 02:04:17.064287, /home/brokenquark/repo-ansi/LearnEra@LearnEra-Configuration/playbooks/roles/edxapp/tasks/deploy.yml,0,0,0,0,3,0,3
2019-03-09 02:04:17.130363, /home/brokenquark/repo-ansi/LearnEra@LearnEra-Configuration/playbooks/roles/rabbitmq/defaults/main.yml,5,0,2,0,0,1,8
2019-03-09 02:04:17.147589, /home/brokenquark/repo-ansi/LearnEra@LearnEra-Configuration/playbooks/roles/rabbitmq/tasks/main.yml,1,0,0,0,1,0,2
2019-03-09 02:04:17.159202, /home/brokenquark/repo-ansi/LearnEra@LearnEra-Configuration/playbooks/roles/analytics-server/defaults/main.yml,8,0,0,0,0,0,8
2019-03-09 02:04:17.189242, /home/brokenquark/repo-ansi/LearnEra@LearnEra-Configuration/playbooks/roles/supervisor/defaults/main.yml,1,0,0,0,0,0,1
2019-03-09 02:04:17.207957, /home/brokenquark/repo-ansi/LearnEra@LearnEra-Configuration/playbooks/roles/browsers/defaults/main.yml,0,0,1,0,0,1,2
2019-03-09 02:04:17.216442, /home/brokenquark/repo-ansi/LearnEra@LearnEra-Configuration/playbooks/roles/nltk/defaults/main.yml,0,0,3,0,0,3,6
2019-03-09 02:04:17.235770, /home/brokenquark/repo-ansi/LearnEra@LearnEra-Configuration/playbooks/roles/discern/defaults/main.yml,5,0,1,0,0,1,7
2019-03-09 02:04:17.271008, /home/brokenquark/repo-ansi/LearnEra@LearnEra-Configuration/playbooks/roles/discern/tasks/main.yml,0,0,0,0,1,0,1
2019-03-09 02:04:17.348848, /home/brokenquark/repo-ansi/LearnEra@LearnEra-Configuration/playbooks/roles/xqwatcher/defaults/main.yml,5,0,0,0,0,0,5
2019-03-09 02:04:17.384651, /home/brokenquark/repo-ansi/LearnEra@LearnEra-Configuration/playbooks/roles/jenkins_worker/defaults/main.yml,1,0,1,0,0,2,4
2019-03-09 02:04:17.398720, /home/brokenquark/repo-ansi/LearnEra@LearnEra-Configuration/playbooks/roles/jenkins_worker/tasks/system.yml,0,0,0,0,2,0,2
2019-03-09 02:04:17.420960, /home/brokenquark/repo-ansi/LearnEra@LearnEra-Configuration/playbooks/roles/datadog/defaults/main.yml,1,0,1,0,0,0,2
2019-03-09 02:04:17.442296, /home/brokenquark/repo-ansi/LearnEra@LearnEra-Configuration/playbooks/roles/xqueue/defaults/main.yml,9,0,0,0,0,0,9
2019-03-09 02:04:17.472957, /home/brokenquark/repo-ansi/LearnEra@LearnEra-Configuration/playbooks/roles/nginx/defaults/main.yml,2,0,0,0,0,0,2
2019-03-09 02:04:17.495623, /home/brokenquark/repo-ansi/LearnEra@LearnEra-Configuration/playbooks/roles/shibboleth/defaults/main.yml,3,0,1,0,0,0,4
2019-03-09 02:04:17.517897, /home/brokenquark/repo-ansi/LearnEra@LearnEra-Configuration/playbooks/roles/local_dev/defaults/main.yml,1,0,0,0,0,0,1
2019-03-09 02:04:17.548001, /home/brokenquark/repo-ansi/LearnEra@LearnEra-Configuration/playbooks/edx-west/stage-worker.yml,1,0,0,0,0,0,1
2019-03-09 02:04:17.613477, /home/brokenquark/repo-ansi/LearnEra@LearnEra-Configuration/playbooks/edx-west/stage-notifier-only.yml,1,0,0,0,0,0,1
2019-03-09 02:04:17.742734, /home/brokenquark/repo-ansi/LearnEra@LearnEra-Configuration/playbooks/edx-east/edx_provision.yml,3,0,0,0,0,0,3
2019-03-09 02:04:17.752276, /home/brokenquark/repo-ansi/LearnEra@LearnEra-Configuration/playbooks/edx-east/add-ubuntu-key.yml,1,0,0,0,0,0,1
2019-03-09 02:04:17.804741, /home/brokenquark/repo-ansi/LearnEra@LearnEra-Configuration/playbooks/edx-east/remove-ubuntu-key.yml,1,0,0,0,0,0,1
2019-03-09 02:04:17.831712, /home/brokenquark/repo-ansi/LearnEra@LearnEra-Configuration/playbooks/edx-east/edx_notifier.yml,5,0,0,0,0,0,5
2019-03-09 02:04:17.880659, /home/brokenquark/repo-ansi/LearnEra@LearnEra-Configuration/playbooks/edx-east/ora2.yml,3,0,0,0,0,0,3
2019-03-09 02:04:17.940688, /home/brokenquark/repo-ansi/LearnEra@LearnEra-Configuration/playbooks/edx-east/create_dbs.yml,4,0,0,0,0,0,4
2019-03-09 02:04:17.954664, /home/brokenquark/repo-ansi/LearnEra@LearnEra-Configuration/playbooks/secure_example/vars/edxapp_ref_custom_vars.yml,2,0,0,0,0,0,2
2019-03-09 02:04:18.010905, /home/brokenquark/repo-ansi/LearnEra@LearnEra-Configuration/playbooks/secure_example/vars/edxapp_ref_vars.yml,34,0,0,0,0,0,34
2019-03-09 02:04:18.015911, /home/brokenquark/repo-ansi/LearnEra@LearnEra-Configuration/playbooks/secure_example/vars/edxapp_ref_users.yml,2,0,0,0,0,0,2
2019-03-09 02:04:18.021826, /home/brokenquark/repo-ansi/LearnEra@LearnEra-Configuration/playbooks/secure_example/vars/gerrit.yml,7,0,0,0,0,0,7
2019-03-09 02:04:32.152795, /home/brokenquark/repo-ansi/PaloAltoNetworks-BD@ansible-pan/ansible-playbooks/pan_demos/vars.yml,2,0,0,0,0,0,2
2019-03-09 02:04:32.277774, /home/brokenquark/repo-ansi/PaloAltoNetworks-BD@ansible-pan/ansible-playbooks/pan_demos/setup_passwd.yml,0,1,0,0,0,0,1
2019-03-09 02:04:32.279080, /home/brokenquark/repo-ansi/PaloAltoNetworks-BD@ansible-pan/ansible-playbooks/pan_demos/vars-sample.yml,2,0,0,0,0,0,2
2019-03-09 02:04:32.319972, /home/brokenquark/repo-ansi/PaloAltoNetworks-BD@ansible-pan/ansible-playbooks/aws/vars-sample.yml,3,0,0,0,0,0,3
2019-03-09 02:04:32.321250, /home/brokenquark/repo-ansi/PaloAltoNetworks-BD@ansible-pan/ansible-playbooks/terraform_integration/vars.yml,2,0,0,0,0,0,2
2019-03-09 02:04:32.353308, /home/brokenquark/repo-ansi/PaloAltoNetworks-BD@ansible-pan/ansible-playbooks/terraform_integration/aws_vm_series_config.yml,0,1,0,0,0,0,1
2019-03-09 02:04:32.354569, /home/brokenquark/repo-ansi/PaloAltoNetworks-BD@ansible-pan/ansible-playbooks/terraform_integration/vars-sample.yml,2,0,0,0,0,0,2
2019-03-09 02:04:32.365310, /home/brokenquark/repo-ansi/PaloAltoNetworks-BD@ansible-pan/ansible-playbooks/basic_plumbing/basic_networking_config.yml,0,1,0,0,0,0,1
2019-03-09 02:04:32.366680, /home/brokenquark/repo-ansi/PaloAltoNetworks-BD@ansible-pan/ansible-playbooks/basic_plumbing/vars-sample.yml,2,0,0,0,0,0,2
2019-03-09 02:04:32.427368, /home/brokenquark/repo-ansi/PaloAltoNetworks-BD@ansible-pan/ansible-playbooks/se_summit_2018/vars.yml,2,0,0,0,0,0,2
2019-03-09 02:04:32.515120, /home/brokenquark/repo-ansi/PaloAltoNetworks-BD@ansible-pan/ansible-playbooks/se_summit_2018/aws_vm_series_config.yml,0,1,0,0,0,0,1
2019-03-09 02:04:32.521574, /home/brokenquark/repo-ansi/PaloAltoNetworks-BD@ansible-pan/ansible-playbooks/se_summit_2018/setup_passwd.yml,0,1,0,0,0,0,1
2019-03-09 02:04:32.522587, /home/brokenquark/repo-ansi/PaloAltoNetworks-BD@ansible-pan/ansible-playbooks/se_summit_2018/vars-sample.yml,2,0,0,0,0,0,2
2019-03-09 02:04:32.523699, /home/brokenquark/repo-ansi/PaloAltoNetworks-BD@ansible-pan/ansible-playbooks/ansible-pull/vars-sample.yml,2,0,0,0,0,0,2
2019-03-09 02:04:32.574497, /home/brokenquark/repo-ansi/PaloAltoNetworks-BD@ansible-pan/ansible-playbooks/srules/vars-sample.yml,2,0,0,0,0,0,2
2019-03-09 02:04:32.780101, /home/brokenquark/repo-ansi/RUedx@configuration/playbooks/check_package_upgrades.yml,1,0,0,0,0,0,1
2019-03-09 02:04:33.014770, /home/brokenquark/repo-ansi/RUedx@configuration/playbooks/roles/jenkins_master/defaults/main.yml,1,0,1,0,0,0,2
2019-03-09 02:04:33.046515, /home/brokenquark/repo-ansi/RUedx@configuration/playbooks/roles/jenkins_master/tasks/main.yml,1,0,1,0,4,0,6
2019-03-09 02:04:33.097169, /home/brokenquark/repo-ansi/RUedx@configuration/playbooks/roles/common/tasks/main.yml,3,0,0,0,2,0,5
2019-03-09 02:04:33.121721, /home/brokenquark/repo-ansi/RUedx@configuration/playbooks/roles/ad_hoc_reporting/tasks/main.yml,4,0,0,0,0,0,4
2019-03-09 02:04:33.145017, /home/brokenquark/repo-ansi/RUedx@configuration/playbooks/roles/harprofiler/defaults/main.yml,1,0,0,0,0,0,1
2019-03-09 02:04:33.154747, /home/brokenquark/repo-ansi/RUedx@configuration/playbooks/roles/harprofiler/tasks/main.yml,1,0,0,0,0,0,1
2019-03-09 02:04:33.187504, /home/brokenquark/repo-ansi/RUedx@configuration/playbooks/roles/edxlocal/tasks/main.yml,2,0,0,0,0,0,2
2019-03-09 02:04:33.192343, /home/brokenquark/repo-ansi/RUedx@configuration/playbooks/roles/newrelic-npi/defaults/main.yml,1,0,0,0,0,0,1
2019-03-09 02:04:33.217937, /home/brokenquark/repo-ansi/RUedx@configuration/playbooks/roles/xserver/defaults/main.yml,2,0,0,0,0,0,2
2019-03-09 02:04:33.249655, /home/brokenquark/repo-ansi/RUedx@configuration/playbooks/roles/xserver/tasks/deploy.yml,2,0,0,0,0,0,2
2019-03-09 02:04:33.260104, /home/brokenquark/repo-ansi/RUedx@configuration/playbooks/roles/xserver/tasks/main.yml,1,0,0,0,0,0,1
2019-03-09 02:04:33.271118, /home/brokenquark/repo-ansi/RUedx@configuration/playbooks/roles/test_build_server/defaults/main.yml,1,0,0,0,0,0,1
2019-03-09 02:04:33.289768, /home/brokenquark/repo-ansi/RUedx@configuration/playbooks/roles/aws/defaults/main.yml,0,0,0,0,2,1,3
2019-03-09 02:04:33.303508, /home/brokenquark/repo-ansi/RUedx@configuration/playbooks/roles/aws/tasks/main.yml,1,0,0,0,2,0,3
2019-03-09 02:04:33.317605, /home/brokenquark/repo-ansi/RUedx@configuration/playbooks/roles/forum/defaults/main.yml,3,0,0,1,0,0,4
2019-03-09 02:04:33.335312, /home/brokenquark/repo-ansi/RUedx@configuration/playbooks/roles/forum/tasks/deploy.yml,1,0,0,0,0,0,1
2019-03-09 02:04:33.344267, /home/brokenquark/repo-ansi/RUedx@configuration/playbooks/roles/forum/tasks/main.yml,2,0,0,0,0,0,2
2019-03-09 02:04:33.355369, /home/brokenquark/repo-ansi/RUedx@configuration/playbooks/roles/go-agent/defaults/main.yml,1,0,0,0,0,0,1
2019-03-09 02:04:33.399955, /home/brokenquark/repo-ansi/RUedx@configuration/playbooks/roles/hadoop_common/defaults/main.yml,1,0,0,0,0,0,1
2019-03-09 02:04:33.433854, /home/brokenquark/repo-ansi/RUedx@configuration/playbooks/roles/hadoop_common/tasks/main.yml,4,0,0,0,0,0,4
2019-03-09 02:04:33.438861, /home/brokenquark/repo-ansi/RUedx@configuration/playbooks/roles/redis/defaults/main.yml,1,1,0,0,0,0,2
2019-03-09 02:04:33.443838, /home/brokenquark/repo-ansi/RUedx@configuration/playbooks/roles/redis/tasks/main.yml,1,0,0,0,0,0,1
2019-03-09 02:04:33.462794, /home/brokenquark/repo-ansi/RUedx@configuration/playbooks/roles/git_clone/tasks/main.yml,1,0,0,0,0,0,1
2019-03-09 02:04:33.467480, /home/brokenquark/repo-ansi/RUedx@configuration/playbooks/roles/elasticsearch/defaults/main.yml,2,0,0,0,0,0,2
2019-03-09 02:04:33.495563, /home/brokenquark/repo-ansi/RUedx@configuration/playbooks/roles/antivirus/defaults/main.yml,1,0,0,0,0,0,1
2019-03-09 02:04:33.521422, /home/brokenquark/repo-ansi/RUedx@configuration/playbooks/roles/logstash/tasks/main.yml,2,0,0,0,0,0,2
2019-03-09 02:04:33.525724, /home/brokenquark/repo-ansi/RUedx@configuration/playbooks/roles/docker-tools/defaults/main.yml,1,0,0,0,0,0,1
2019-03-09 02:04:33.541263, /home/brokenquark/repo-ansi/RUedx@configuration/playbooks/roles/flower/defaults/main.yml,4,0,0,1,0,0,5
2019-03-09 02:04:33.576869, /home/brokenquark/repo-ansi/RUedx@configuration/playbooks/roles/harstorage/defaults/main.yml,2,0,0,1,0,1,4
2019-03-09 02:04:33.597451, /home/brokenquark/repo-ansi/RUedx@configuration/playbooks/roles/harstorage/tasks/main.yml,2,0,0,0,0,0,2
2019-03-09 02:04:33.613505, /home/brokenquark/repo-ansi/RUedx@configuration/playbooks/roles/go-server/defaults/main.yml,3,3,0,0,0,0,6
2019-03-09 02:04:33.619584, /home/brokenquark/repo-ansi/RUedx@configuration/playbooks/roles/go-server/tasks/setup_regular_backup.yml,1,0,0,0,0,0,1
2019-03-09 02:04:33.664183, /home/brokenquark/repo-ansi/RUedx@configuration/playbooks/roles/go-server/tasks/main.yml,7,0,0,0,0,0,7
2019-03-09 02:04:33.690992, /home/brokenquark/repo-ansi/RUedx@configuration/playbooks/roles/gh_mirror/defaults/main.yml,1,0,0,0,0,0,1
2019-03-09 02:04:33.707705, /home/brokenquark/repo-ansi/RUedx@configuration/playbooks/roles/sqoop/defaults/main.yml,0,0,2,0,0,0,2
2019-03-09 02:04:33.747374, /home/brokenquark/repo-ansi/RUedx@configuration/playbooks/roles/common_vars/defaults/main.yml,11,1,1,0,0,0,13
2019-03-09 02:04:33.751379, /home/brokenquark/repo-ansi/RUedx@configuration/playbooks/roles/edx-sandbox/tasks/main.yml,1,0,0,0,0,0,1
2019-03-09 02:04:33.757506, /home/brokenquark/repo-ansi/RUedx@configuration/playbooks/roles/server_utils/tasks/main.yml,0,0,0,0,1,0,1
2019-03-09 02:04:33.767557, /home/brokenquark/repo-ansi/RUedx@configuration/playbooks/roles/elasticsearch-monitor/tasks/main.yml,1,0,0,0,0,0,1
2019-03-09 02:04:33.802708, /home/brokenquark/repo-ansi/RUedx@configuration/playbooks/roles/tools_jenkins/meta/main.yml,0,0,1,0,0,0,1
2019-03-09 02:04:33.873269, /home/brokenquark/repo-ansi/RUedx@configuration/playbooks/roles/rbenv/tasks/main.yml,2,0,0,0,0,0,2
2019-03-09 02:04:33.879940, /home/brokenquark/repo-ansi/RUedx@configuration/playbooks/roles/user/defaults/main.yml,0,0,0,0,1,0,1
2019-03-09 02:04:33.933237, /home/brokenquark/repo-ansi/RUedx@configuration/playbooks/roles/user/tasks/main.yml,4,0,0,0,0,0,4
2019-03-09 02:04:33.974750, /home/brokenquark/repo-ansi/RUedx@configuration/playbooks/roles/ecommerce/defaults/main.yml,8,0,0,0,1,0,9
2019-03-09 02:04:34.013441, /home/brokenquark/repo-ansi/RUedx@configuration/playbooks/roles/ecommerce/tasks/main.yml,0,0,0,0,1,0,1
2019-03-09 02:04:34.021502, /home/brokenquark/repo-ansi/RUedx@configuration/playbooks/roles/newrelic/defaults/main.yml,0,0,0,0,0,1,1
2019-03-09 02:04:34.032599, /home/brokenquark/repo-ansi/RUedx@configuration/playbooks/roles/newrelic/tasks/main.yml,1,0,0,0,0,0,1
2019-03-09 02:04:34.045918, /home/brokenquark/repo-ansi/RUedx@configuration/playbooks/roles/alton/defaults/main.yml,6,0,0,0,0,0,6
2019-03-09 02:04:34.059900, /home/brokenquark/repo-ansi/RUedx@configuration/playbooks/roles/alton/tasks/deploy.yml,1,0,0,0,0,0,1
2019-03-09 02:04:34.082084, /home/brokenquark/repo-ansi/RUedx@configuration/playbooks/roles/haproxy/tasks/main.yml,1,0,0,0,0,0,1
2019-03-09 02:04:34.093668, /home/brokenquark/repo-ansi/RUedx@configuration/playbooks/roles/xsy/defaults/main.yml,5,0,0,0,0,0,5
2019-03-09 02:04:34.109745, /home/brokenquark/repo-ansi/RUedx@configuration/playbooks/roles/xsy/tasks/main.yml,1,0,0,0,0,0,1
2019-03-09 02:04:34.133566, /home/brokenquark/repo-ansi/RUedx@configuration/playbooks/roles/gluster/tasks/main.yml,0,0,0,0,1,0,1
2019-03-09 02:04:34.139800, /home/brokenquark/repo-ansi/RUedx@configuration/playbooks/roles/android_sdk/defaults/main.yml,1,0,0,0,0,0,1
2019-03-09 02:04:34.157131, /home/brokenquark/repo-ansi/RUedx@configuration/playbooks/roles/android_sdk/tasks/main.yml,0,0,0,0,1,0,1
2019-03-09 02:04:34.160148, /home/brokenquark/repo-ansi/RUedx@configuration/playbooks/roles/swapfile/defaults/main.yml,0,0,0,0,1,0,1
2019-03-09 02:04:34.182171, /home/brokenquark/repo-ansi/RUedx@configuration/playbooks/roles/certs/defaults/main.yml,4,0,0,0,0,0,4
2019-03-09 02:04:34.202754, /home/brokenquark/repo-ansi/RUedx@configuration/playbooks/roles/certs/tasks/deploy.yml,2,0,0,0,0,0,2
2019-03-09 02:04:34.224131, /home/brokenquark/repo-ansi/RUedx@configuration/playbooks/roles/demo/defaults/main.yml,7,0,0,0,0,0,7
2019-03-09 02:04:34.234867, /home/brokenquark/repo-ansi/RUedx@configuration/playbooks/roles/demo/tasks/deploy.yml,1,0,0,0,0,0,1
2019-03-09 02:04:34.241627, /home/brokenquark/repo-ansi/RUedx@configuration/playbooks/roles/oraclejdk/defaults/main.yml,0,0,1,0,0,0,1
2019-03-09 02:04:34.250033, /home/brokenquark/repo-ansi/RUedx@configuration/playbooks/roles/oraclejdk/tasks/main.yml,2,0,0,0,0,0,2
2019-03-09 02:04:34.262297, /home/brokenquark/repo-ansi/RUedx@configuration/playbooks/roles/munin_node/tasks/main.yml,3,0,0,0,0,0,3
2019-03-09 02:04:34.272034, /home/brokenquark/repo-ansi/RUedx@configuration/playbooks/roles/splunkforwarder/defaults/main.yml,0,1,0,0,0,0,1
2019-03-09 02:04:34.290641, /home/brokenquark/repo-ansi/RUedx@configuration/playbooks/roles/splunkforwarder/tasks/main.yml,6,0,0,0,0,0,6
2019-03-09 02:04:34.310241, /home/brokenquark/repo-ansi/RUedx@configuration/playbooks/roles/notifier/defaults/main.yml,2,2,0,0,0,0,4
2019-03-09 02:04:34.325168, /home/brokenquark/repo-ansi/RUedx@configuration/playbooks/roles/notifier/tasks/deploy.yml,2,0,0,0,0,0,2
2019-03-09 02:04:34.350441, /home/brokenquark/repo-ansi/RUedx@configuration/playbooks/roles/notifier/tasks/main.yml,1,0,0,0,0,0,1
2019-03-09 02:04:34.372464, /home/brokenquark/repo-ansi/RUedx@configuration/playbooks/roles/mysql/tasks/mysql.yml,1,0,0,0,0,0,1
2019-03-09 02:04:34.375441, /home/brokenquark/repo-ansi/RUedx@configuration/playbooks/roles/automated/defaults/main.yml,1,0,0,0,0,0,1
2019-03-09 02:04:34.384806, /home/brokenquark/repo-ansi/RUedx@configuration/playbooks/roles/automated/tasks/main.yml,1,0,0,0,0,0,1
2019-03-09 02:04:34.389783, /home/brokenquark/repo-ansi/RUedx@configuration/playbooks/roles/edx_ansible/defaults/main.yml,1,0,0,0,0,0,1
2019-03-09 02:04:34.403233, /home/brokenquark/repo-ansi/RUedx@configuration/playbooks/roles/edx_ansible/tasks/deploy.yml,1,0,0,0,0,0,1
2019-03-09 02:04:34.422737, /home/brokenquark/repo-ansi/RUedx@configuration/playbooks/roles/security/tasks/security-ubuntu.yml,2,0,0,0,1,0,3
2019-03-09 02:04:34.434654, /home/brokenquark/repo-ansi/RUedx@configuration/playbooks/roles/add_user/tasks/main.yml,2,0,0,0,0,0,2
2019-03-09 02:04:34.439423, /home/brokenquark/repo-ansi/RUedx@configuration/playbooks/roles/neo4j/defaults/main.yml,2,0,0,1,0,0,3
2019-03-09 02:04:34.451931, /home/brokenquark/repo-ansi/RUedx@configuration/playbooks/roles/snort/defaults/main.yml,0,0,2,0,0,1,3
2019-03-09 02:04:34.459722, /home/brokenquark/repo-ansi/RUedx@configuration/playbooks/roles/snort/tasks/main.yml,4,0,0,0,0,0,4
2019-03-09 02:04:34.476485, /home/brokenquark/repo-ansi/RUedx@configuration/playbooks/roles/mariadb/defaults/main.yml,3,0,0,0,0,0,3
2019-03-09 02:04:34.498263, /home/brokenquark/repo-ansi/RUedx@configuration/playbooks/roles/mariadb/tasks/cluster.yml,2,0,0,0,0,0,2
2019-03-09 02:04:34.509233, /home/brokenquark/repo-ansi/RUedx@configuration/playbooks/roles/kibana/tasks/main.yml,2,0,0,0,0,0,2
2019-03-09 02:04:34.527269, /home/brokenquark/repo-ansi/RUedx@configuration/playbooks/roles/minos/tasks/main.yml,3,0,0,0,0,0,3
2019-03-09 02:04:34.530230, /home/brokenquark/repo-ansi/RUedx@configuration/playbooks/roles/minos/meta/main.yml,1,0,0,0,0,0,1
2019-03-09 02:04:34.534166, /home/brokenquark/repo-ansi/RUedx@configuration/playbooks/roles/openstack/defaults/main.yml,0,1,0,0,1,0,2
2019-03-09 02:04:34.543724, /home/brokenquark/repo-ansi/RUedx@configuration/playbooks/roles/openstack/tasks/main.yml,2,0,0,0,0,0,2
2019-03-09 02:04:34.580313, /home/brokenquark/repo-ansi/RUedx@configuration/playbooks/roles/jenkins_analytics/defaults/main.yml,9,2,0,0,0,0,11
2019-03-09 02:04:34.611701, /home/brokenquark/repo-ansi/RUedx@configuration/playbooks/roles/jenkins_analytics/tasks/main.yml,4,0,0,0,0,0,4
2019-03-09 02:04:34.644282, /home/brokenquark/repo-ansi/RUedx@configuration/playbooks/roles/gitreload/defaults/main.yml,1,0,0,0,0,0,1
2019-03-09 02:04:34.656097, /home/brokenquark/repo-ansi/RUedx@configuration/playbooks/roles/gitreload/tasks/deploy.yml,1,0,0,0,0,0,1
2019-03-09 02:04:34.686088, /home/brokenquark/repo-ansi/RUedx@configuration/playbooks/roles/locust/defaults/main.yml,1,0,0,0,0,0,1
2019-03-09 02:04:34.708548, /home/brokenquark/repo-ansi/RUedx@configuration/playbooks/roles/s3fs/defaults/main.yml,0,0,1,0,0,0,1
2019-03-09 02:04:34.737002, /home/brokenquark/repo-ansi/RUedx@configuration/playbooks/roles/programs/defaults/main.yml,5,0,0,0,1,0,6
2019-03-09 02:04:34.988861, /home/brokenquark/repo-ansi/RUedx@configuration/playbooks/roles/edxapp/defaults/main.yml,17,1,4,0,1,0,23
2019-03-09 02:04:35.002999, /home/brokenquark/repo-ansi/RUedx@configuration/playbooks/roles/edxapp/tasks/python_sandbox_env.yml,2,0,0,0,0,0,2
2019-03-09 02:04:35.063914, /home/brokenquark/repo-ansi/RUedx@configuration/playbooks/roles/edxapp/tasks/deploy.yml,2,0,0,0,2,0,4
2019-03-09 02:04:35.088031, /home/brokenquark/repo-ansi/RUedx@configuration/playbooks/roles/edxapp/tasks/service_variant_config.yml,0,0,0,0,1,0,1
2019-03-09 02:04:35.113870, /home/brokenquark/repo-ansi/RUedx@configuration/playbooks/roles/edxapp/tasks/main.yml,2,0,0,0,0,0,2
2019-03-09 02:04:35.134906, /home/brokenquark/repo-ansi/RUedx@configuration/playbooks/roles/edx_notes_api/defaults/main.yml,3,0,0,0,0,0,3
2019-03-09 02:04:35.181537, /home/brokenquark/repo-ansi/RUedx@configuration/playbooks/roles/rabbitmq/defaults/main.yml,4,0,1,0,0,1,6
2019-03-09 02:04:35.207666, /home/brokenquark/repo-ansi/RUedx@configuration/playbooks/roles/rabbitmq/tasks/main.yml,7,0,0,0,1,0,8
2019-03-09 02:04:35.215145, /home/brokenquark/repo-ansi/RUedx@configuration/playbooks/roles/analytics_pipeline/defaults/main.yml,2,0,0,0,0,0,2
2019-03-09 02:04:35.272000, /home/brokenquark/repo-ansi/RUedx@configuration/playbooks/roles/insights/defaults/main.yml,7,0,1,0,0,0,8
2019-03-09 02:04:35.298608, /home/brokenquark/repo-ansi/RUedx@configuration/playbooks/roles/insights/tasks/main.yml,0,0,0,0,1,0,1
2019-03-09 02:04:35.310398, /home/brokenquark/repo-ansi/RUedx@configuration/playbooks/roles/splunk-server/defaults/main.yml,4,1,0,0,0,0,5
2019-03-09 02:04:35.330805, /home/brokenquark/repo-ansi/RUedx@configuration/playbooks/roles/splunk-server/tasks/main.yml,3,0,0,0,0,0,3
2019-03-09 02:04:35.350572, /home/brokenquark/repo-ansi/RUedx@configuration/playbooks/roles/ecomworker/defaults/main.yml,5,0,0,0,0,0,5
2019-03-09 02:04:35.388338, /home/brokenquark/repo-ansi/RUedx@configuration/playbooks/roles/mount_ebs/tasks/main.yml,0,0,0,0,2,0,2
2019-03-09 02:04:35.398993, /home/brokenquark/repo-ansi/RUedx@configuration/playbooks/roles/supervisor/defaults/main.yml,1,0,0,0,0,0,1
2019-03-09 02:04:35.429499, /home/brokenquark/repo-ansi/RUedx@configuration/playbooks/roles/supervisor/tasks/main.yml,3,0,0,0,0,0,3
2019-03-09 02:04:35.435312, /home/brokenquark/repo-ansi/RUedx@configuration/playbooks/roles/browsers/defaults/main.yml,0,0,1,0,0,1,2
2019-03-09 02:04:35.460002, /home/brokenquark/repo-ansi/RUedx@configuration/playbooks/roles/browsers/tasks/main.yml,1,0,0,0,0,0,1
2019-03-09 02:04:35.467958, /home/brokenquark/repo-ansi/RUedx@configuration/playbooks/roles/postfix_queue/defaults/main.yml,0,1,0,0,5,0,6
2019-03-09 02:04:35.479799, /home/brokenquark/repo-ansi/RUedx@configuration/playbooks/roles/postfix_queue/tasks/main.yml,2,0,0,0,2,0,4
2019-03-09 02:04:35.482491, /home/brokenquark/repo-ansi/RUedx@configuration/playbooks/roles/nltk/defaults/main.yml,0,0,3,0,0,3,6
2019-03-09 02:04:35.521955, /home/brokenquark/repo-ansi/RUedx@configuration/playbooks/roles/analytics_api/defaults/main.yml,8,0,0,0,0,0,8
2019-03-09 02:04:35.549813, /home/brokenquark/repo-ansi/RUedx@configuration/playbooks/roles/go-agent-docker-server/tasks/main.yml,1,0,0,0,0,0,1
2019-03-09 02:04:35.613869, /home/brokenquark/repo-ansi/RUedx@configuration/playbooks/roles/jenkins_admin/tasks/main.yml,1,0,0,0,0,0,1
2019-03-09 02:04:35.637216, /home/brokenquark/repo-ansi/RUedx@configuration/playbooks/roles/mongo_3_0/defaults/main.yml,7,0,0,0,0,0,7
2019-03-09 02:04:35.689447, /home/brokenquark/repo-ansi/RUedx@configuration/playbooks/roles/mongo_3_0/tasks/main.yml,2,0,0,0,0,0,2
2019-03-09 02:04:35.734209, /home/brokenquark/repo-ansi/RUedx@configuration/playbooks/roles/discovery/defaults/main.yml,6,1,0,0,0,0,7
2019-03-09 02:04:35.774991, /home/brokenquark/repo-ansi/RUedx@configuration/playbooks/roles/discovery/tasks/main.yml,2,0,0,0,1,0,3
2019-03-09 02:04:35.790478, /home/brokenquark/repo-ansi/RUedx@configuration/playbooks/roles/apache/tasks/main.yml,3,0,0,0,0,0,3
2019-03-09 02:04:35.833674, /home/brokenquark/repo-ansi/RUedx@configuration/playbooks/roles/xqwatcher/tasks/code_jail.yml,3,0,0,0,1,0,4
2019-03-09 02:04:35.876947, /home/brokenquark/repo-ansi/RUedx@configuration/playbooks/roles/jenkins_worker/defaults/main.yml,1,0,0,0,0,1,2
2019-03-09 02:04:35.885279, /home/brokenquark/repo-ansi/RUedx@configuration/playbooks/roles/jenkins_worker/tasks/system.yml,0,0,0,0,1,0,1
2019-03-09 02:04:35.890491, /home/brokenquark/repo-ansi/RUedx@configuration/playbooks/roles/jenkins_worker/tasks/test_platform_worker.yml,0,0,0,0,1,0,1
2019-03-09 02:04:35.926637, /home/brokenquark/repo-ansi/RUedx@configuration/playbooks/roles/jenkins_worker/meta/main.yml,1,0,0,0,0,0,1
2019-03-09 02:04:35.932850, /home/brokenquark/repo-ansi/RUedx@configuration/playbooks/roles/aide/tasks/main.yml,1,0,0,0,0,0,1
2019-03-09 02:04:35.934870, /home/brokenquark/repo-ansi/RUedx@configuration/playbooks/roles/datadog/defaults/main.yml,1,0,0,0,0,0,1
2019-03-09 02:04:35.943578, /home/brokenquark/repo-ansi/RUedx@configuration/playbooks/roles/datadog/tasks/main.yml,1,0,0,0,0,0,1
2019-03-09 02:04:35.949558, /home/brokenquark/repo-ansi/RUedx@configuration/playbooks/roles/vhost/defaults/main.yml,3,0,0,0,0,0,3
2019-03-09 02:04:35.962226, /home/brokenquark/repo-ansi/RUedx@configuration/playbooks/roles/vhost/tasks/main.yml,3,0,0,0,0,0,3
2019-03-09 02:04:35.984765, /home/brokenquark/repo-ansi/RUedx@configuration/playbooks/roles/xqueue/defaults/main.yml,5,0,0,0,0,0,5
2019-03-09 02:04:36.008803, /home/brokenquark/repo-ansi/RUedx@configuration/playbooks/roles/xqueue/tasks/deploy.yml,1,0,0,0,0,0,1
2019-03-09 02:04:36.034496, /home/brokenquark/repo-ansi/RUedx@configuration/playbooks/roles/nginx/defaults/main.yml,2,0,0,0,0,0,2
2019-03-09 02:04:36.085641, /home/brokenquark/repo-ansi/RUedx@configuration/playbooks/roles/nginx/tasks/main.yml,15,1,1,0,0,0,17
2019-03-09 02:04:36.100053, /home/brokenquark/repo-ansi/RUedx@configuration/playbooks/roles/mongo_2_6/defaults/main.yml,7,0,0,0,0,0,7
2019-03-09 02:04:36.138518, /home/brokenquark/repo-ansi/RUedx@configuration/playbooks/roles/mongo_2_6/tasks/main.yml,3,0,0,0,0,0,3
2019-03-09 02:04:36.144949, /home/brokenquark/repo-ansi/RUedx@configuration/playbooks/roles/shibboleth/defaults/main.yml,3,0,1,0,0,0,4
2019-03-09 02:04:36.151593, /home/brokenquark/repo-ansi/RUedx@configuration/playbooks/roles/shibboleth/tasks/main.yml,1,0,0,0,0,0,1
2019-03-09 02:04:36.182311, /home/brokenquark/repo-ansi/RUedx@configuration/playbooks/roles/credentials/defaults/main.yml,4,0,0,0,1,0,5
2019-03-09 02:04:36.217769, /home/brokenquark/repo-ansi/RUedx@configuration/playbooks/roles/credentials/tasks/main.yml,2,0,0,0,1,0,3
2019-03-09 02:04:36.222663, /home/brokenquark/repo-ansi/RUedx@configuration/playbooks/roles/jscover/defaults/main.yml,0,0,1,0,0,0,1
2019-03-09 02:04:36.242524, /home/brokenquark/repo-ansi/RUedx@configuration/playbooks/roles/edx_service/tasks/main.yml,1,0,0,0,0,0,1
2019-03-09 02:04:36.253200, /home/brokenquark/repo-ansi/RUedx@configuration/playbooks/roles/hive/defaults/main.yml,2,0,1,0,0,0,3
2019-03-09 02:04:36.276149, /home/brokenquark/repo-ansi/RUedx@configuration/playbooks/roles/local_dev/defaults/main.yml,1,0,0,0,0,0,1
2019-03-09 02:04:36.294589, /home/brokenquark/repo-ansi/RUedx@configuration/playbooks/roles/local_dev/tasks/main.yml,1,0,0,0,0,0,1
2019-03-09 02:04:36.298999, /home/brokenquark/repo-ansi/RUedx@configuration/playbooks/roles/cassandra/defaults/main.yml,1,0,0,0,0,0,1
2019-03-09 02:04:36.308735, /home/brokenquark/repo-ansi/RUedx@configuration/playbooks/roles/cassandra/tasks/main.yml,0,0,1,0,0,0,1
2019-03-09 02:04:36.402645, /home/brokenquark/repo-ansi/RUedx@configuration/playbooks/edx-east/mongo_rolling_upgrade.yml,3,0,0,0,0,0,3
2019-03-09 02:04:36.479065, /home/brokenquark/repo-ansi/RUedx@configuration/playbooks/edx-east/promote_rds_secondary.yml,0,1,0,0,0,0,1
2019-03-09 02:04:36.528036, /home/brokenquark/repo-ansi/RUedx@configuration/playbooks/edx-east/edx_provision.yml,3,0,0,0,0,0,3
2019-03-09 02:04:36.541542, /home/brokenquark/repo-ansi/RUedx@configuration/playbooks/edx-east/add-ubuntu-key.yml,1,0,0,0,0,0,1
2019-03-09 02:04:36.587181, /home/brokenquark/repo-ansi/RUedx@configuration/playbooks/edx-east/remove-ubuntu-key.yml,1,0,0,0,0,0,1
2019-03-09 02:04:36.621130, /home/brokenquark/repo-ansi/RUedx@configuration/playbooks/edx-east/edx_notifier.yml,5,0,0,0,0,0,5
2019-03-09 02:04:36.634885, /home/brokenquark/repo-ansi/RUedx@configuration/playbooks/edx-east/legacy_certificates.yml,2,0,0,0,0,0,2
2019-03-09 02:04:36.706530, /home/brokenquark/repo-ansi/RUedx@configuration/playbooks/edx-east/mongo_upgrade_hidden_secondaries.yml,1,0,0,0,1,0,2
2019-03-09 02:04:36.730459, /home/brokenquark/repo-ansi/RUedx@configuration/playbooks/edx-east/ora2.yml,3,0,0,0,0,0,3
2019-03-09 02:04:37.259131, /home/brokenquark/repo-ansi/RedHatQE@cinch/cinch/playbooks/jenkins_backup.yml,1,0,0,0,0,0,1
2019-03-09 02:04:37.301562, /home/brokenquark/repo-ansi/RedHatQE@cinch/cinch/playbooks/jenkins_restart_utility.yml,3,0,0,0,0,0,3
2019-03-09 02:04:44.238740, /home/brokenquark/repo-ansi/SatelliteQE@robottelo-ci/ansible/playbooks/clone_compose_repo.yml,1,0,0,0,0,0,1
2019-03-09 02:04:44.256876, /home/brokenquark/repo-ansi/SatelliteQE@robottelo-ci/ansible/playbooks/generate_compose.yml,1,0,0,0,0,0,1
2019-03-09 02:04:44.264788, /home/brokenquark/repo-ansi/SatelliteQE@robottelo-ci/ansible/playbooks/build_compose.yml,1,0,0,0,0,0,1
2019-03-09 02:04:44.267412, /home/brokenquark/repo-ansi/SatelliteQE@robottelo-ci/ansible/playbooks/update_packaging_repo.yml,1,0,0,0,0,0,1
2019-03-09 02:05:02.107509, /home/brokenquark/repo-ansi/UXE@edx-configuration/playbooks/roles/jenkins_master/defaults/main.yml,1,0,1,0,0,0,2
2019-03-09 02:05:02.124906, /home/brokenquark/repo-ansi/UXE@edx-configuration/playbooks/roles/jenkins_master/tasks/main.yml,0,0,0,0,4,0,4
2019-03-09 02:05:02.139223, /home/brokenquark/repo-ansi/UXE@edx-configuration/playbooks/roles/common/defaults/main.yml,11,1,2,0,0,0,14
2019-03-09 02:05:02.152619, /home/brokenquark/repo-ansi/UXE@edx-configuration/playbooks/roles/common/tasks/main.yml,0,0,0,0,1,0,1
2019-03-09 02:05:02.157961, /home/brokenquark/repo-ansi/UXE@edx-configuration/playbooks/roles/harprofiler/defaults/main.yml,1,0,0,0,0,0,1
2019-03-09 02:05:02.193661, /home/brokenquark/repo-ansi/UXE@edx-configuration/playbooks/roles/gerrit/defaults/main.yml,1,0,0,0,0,0,1
2019-03-09 02:05:02.226556, /home/brokenquark/repo-ansi/UXE@edx-configuration/playbooks/roles/xserver/defaults/main.yml,2,0,0,0,0,0,2
2019-03-09 02:05:02.260062, /home/brokenquark/repo-ansi/UXE@edx-configuration/playbooks/roles/test_build_server/defaults/main.yml,1,0,0,0,0,0,1
2019-03-09 02:05:02.275981, /home/brokenquark/repo-ansi/UXE@edx-configuration/playbooks/roles/aws/defaults/main.yml,3,0,1,0,1,1,6
2019-03-09 02:05:02.290389, /home/brokenquark/repo-ansi/UXE@edx-configuration/playbooks/roles/aws/tasks/main.yml,1,0,0,0,0,0,1
2019-03-09 02:05:02.305571, /home/brokenquark/repo-ansi/UXE@edx-configuration/playbooks/roles/forum/defaults/main.yml,3,0,0,1,0,0,4
2019-03-09 02:05:02.355407, /home/brokenquark/repo-ansi/UXE@edx-configuration/playbooks/roles/analytics-api/defaults/main.yml,9,0,0,0,0,0,9
2019-03-09 02:05:02.421684, /home/brokenquark/repo-ansi/UXE@edx-configuration/playbooks/roles/ora/defaults/main.yml,7,0,0,0,0,0,7
2019-03-09 02:05:02.460345, /home/brokenquark/repo-ansi/UXE@edx-configuration/playbooks/roles/redis/defaults/main.yml,1,1,0,0,0,0,2
2019-03-09 02:05:02.469465, /home/brokenquark/repo-ansi/UXE@edx-configuration/playbooks/roles/elasticsearch/defaults/main.yml,1,0,0,0,0,0,1
2019-03-09 02:05:02.490475, /home/brokenquark/repo-ansi/UXE@edx-configuration/playbooks/roles/antivirus/defaults/main.yml,1,0,0,0,0,0,1
2019-03-09 02:05:02.524210, /home/brokenquark/repo-ansi/UXE@edx-configuration/playbooks/roles/flower/defaults/main.yml,3,0,0,1,0,0,4
2019-03-09 02:05:02.541965, /home/brokenquark/repo-ansi/UXE@edx-configuration/playbooks/roles/gh_mirror/defaults/main.yml,1,0,0,0,0,0,1
2019-03-09 02:05:02.557420, /home/brokenquark/repo-ansi/UXE@edx-configuration/playbooks/roles/devpi/defaults/main.yml,2,0,0,0,0,0,2
2019-03-09 02:05:02.595269, /home/brokenquark/repo-ansi/UXE@edx-configuration/playbooks/roles/user/defaults/main.yml,0,0,0,0,1,0,1
2019-03-09 02:05:02.622849, /home/brokenquark/repo-ansi/UXE@edx-configuration/playbooks/roles/newrelic/tasks/newrelic-logwatcher.yml,1,0,0,0,0,0,1
2019-03-09 02:05:02.643272, /home/brokenquark/repo-ansi/UXE@edx-configuration/playbooks/roles/newrelic/meta/main.yml,2,0,0,0,0,0,2
2019-03-09 02:05:02.650556, /home/brokenquark/repo-ansi/UXE@edx-configuration/playbooks/roles/alton/defaults/main.yml,4,0,0,0,0,0,4
2019-03-09 02:05:02.693483, /home/brokenquark/repo-ansi/UXE@edx-configuration/playbooks/roles/gluster/tasks/main.yml,0,0,0,0,1,0,1
2019-03-09 02:05:02.704780, /home/brokenquark/repo-ansi/UXE@edx-configuration/playbooks/roles/certs/defaults/main.yml,4,0,0,0,0,0,4
2019-03-09 02:05:02.737013, /home/brokenquark/repo-ansi/UXE@edx-configuration/playbooks/roles/demo/defaults/main.yml,6,0,0,0,0,0,6
2019-03-09 02:05:02.747942, /home/brokenquark/repo-ansi/UXE@edx-configuration/playbooks/roles/oraclejdk/defaults/main.yml,0,0,1,0,0,0,1
2019-03-09 02:05:02.760033, /home/brokenquark/repo-ansi/UXE@edx-configuration/playbooks/roles/splunkforwarder/defaults/main.yml,0,1,0,0,0,0,1
2019-03-09 02:05:02.770599, /home/brokenquark/repo-ansi/UXE@edx-configuration/playbooks/roles/splunkforwarder/tasks/main.yml,1,0,0,0,0,0,1
2019-03-09 02:05:02.788827, /home/brokenquark/repo-ansi/UXE@edx-configuration/playbooks/roles/notifier/defaults/main.yml,2,2,0,0,0,0,4
2019-03-09 02:05:02.821160, /home/brokenquark/repo-ansi/UXE@edx-configuration/playbooks/roles/edx_ansible/defaults/main.yml,1,0,0,0,0,0,1
2019-03-09 02:05:02.856521, /home/brokenquark/repo-ansi/UXE@edx-configuration/playbooks/roles/snort/defaults/main.yml,0,0,2,0,0,1,3
2019-03-09 02:05:02.875655, /home/brokenquark/repo-ansi/UXE@edx-configuration/playbooks/roles/mariadb/defaults/main.yml,3,0,0,0,0,0,3
2019-03-09 02:05:02.934772, /home/brokenquark/repo-ansi/UXE@edx-configuration/playbooks/roles/gitreload/defaults/main.yml,1,0,0,0,0,0,1
2019-03-09 02:05:02.965686, /home/brokenquark/repo-ansi/UXE@edx-configuration/playbooks/roles/s3fs/defaults/main.yml,0,0,1,0,0,0,1
2019-03-09 02:05:02.977750, /home/brokenquark/repo-ansi/UXE@edx-configuration/playbooks/roles/mongo/defaults/main.yml,7,0,1,0,0,0,8
2019-03-09 02:05:03.098115, /home/brokenquark/repo-ansi/UXE@edx-configuration/playbooks/roles/edxapp/defaults/main.yml,15,2,4,0,1,0,22
2019-03-09 02:05:03.164310, /home/brokenquark/repo-ansi/UXE@edx-configuration/playbooks/roles/edxapp/tasks/deploy.yml,0,0,0,0,3,0,3
2019-03-09 02:05:03.212140, /home/brokenquark/repo-ansi/UXE@edx-configuration/playbooks/roles/rabbitmq/defaults/main.yml,5,0,2,0,0,1,8
2019-03-09 02:05:03.226045, /home/brokenquark/repo-ansi/UXE@edx-configuration/playbooks/roles/rabbitmq/tasks/main.yml,1,0,0,0,1,0,2
2019-03-09 02:05:03.246034, /home/brokenquark/repo-ansi/UXE@edx-configuration/playbooks/roles/insights/defaults/main.yml,7,0,1,0,0,0,8
2019-03-09 02:05:03.268276, /home/brokenquark/repo-ansi/UXE@edx-configuration/playbooks/roles/supervisor/defaults/main.yml,1,0,0,0,0,0,1
2019-03-09 02:05:03.285535, /home/brokenquark/repo-ansi/UXE@edx-configuration/playbooks/roles/browsers/defaults/main.yml,0,0,1,0,0,1,2
2019-03-09 02:05:03.294017, /home/brokenquark/repo-ansi/UXE@edx-configuration/playbooks/roles/nltk/defaults/main.yml,0,0,3,0,0,3,6
2019-03-09 02:05:03.316146, /home/brokenquark/repo-ansi/UXE@edx-configuration/playbooks/roles/discern/defaults/main.yml,3,0,1,0,0,1,5
2019-03-09 02:05:03.344017, /home/brokenquark/repo-ansi/UXE@edx-configuration/playbooks/roles/discern/tasks/main.yml,0,0,0,0,1,0,1
2019-03-09 02:05:03.448937, /home/brokenquark/repo-ansi/UXE@edx-configuration/playbooks/roles/xqwatcher/defaults/main.yml,5,0,0,0,0,0,5
2019-03-09 02:05:03.495065, /home/brokenquark/repo-ansi/UXE@edx-configuration/playbooks/roles/jenkins_worker/defaults/main.yml,1,0,1,0,0,2,4
2019-03-09 02:05:03.512656, /home/brokenquark/repo-ansi/UXE@edx-configuration/playbooks/roles/jenkins_worker/tasks/system.yml,0,0,0,0,2,0,2
2019-03-09 02:05:03.538010, /home/brokenquark/repo-ansi/UXE@edx-configuration/playbooks/roles/datadog/defaults/main.yml,1,0,0,0,0,0,1
2019-03-09 02:05:03.561758, /home/brokenquark/repo-ansi/UXE@edx-configuration/playbooks/roles/xqueue/defaults/main.yml,5,0,0,0,0,0,5
2019-03-09 02:05:03.611723, /home/brokenquark/repo-ansi/UXE@edx-configuration/playbooks/roles/nginx/defaults/main.yml,2,0,0,0,0,0,2
2019-03-09 02:05:03.638263, /home/brokenquark/repo-ansi/UXE@edx-configuration/playbooks/roles/shibboleth/defaults/main.yml,3,0,1,0,0,0,4
2019-03-09 02:05:03.661285, /home/brokenquark/repo-ansi/UXE@edx-configuration/playbooks/roles/local_dev/defaults/main.yml,1,0,0,0,0,0,1
2019-03-09 02:05:03.693824, /home/brokenquark/repo-ansi/UXE@edx-configuration/playbooks/edx-west/stage-worker.yml,1,0,0,0,0,0,1
2019-03-09 02:05:03.767426, /home/brokenquark/repo-ansi/UXE@edx-configuration/playbooks/edx-west/stage-notifier-only.yml,1,0,0,0,0,0,1
2019-03-09 02:05:03.943636, /home/brokenquark/repo-ansi/UXE@edx-configuration/playbooks/edx-east/edx_provision.yml,3,0,0,0,0,0,3
2019-03-09 02:05:03.953688, /home/brokenquark/repo-ansi/UXE@edx-configuration/playbooks/edx-east/add-ubuntu-key.yml,1,0,0,0,0,0,1
2019-03-09 02:05:04.007400, /home/brokenquark/repo-ansi/UXE@edx-configuration/playbooks/edx-east/remove-ubuntu-key.yml,1,0,0,0,0,0,1
2019-03-09 02:05:04.033440, /home/brokenquark/repo-ansi/UXE@edx-configuration/playbooks/edx-east/edx_notifier.yml,5,0,0,0,0,0,5
2019-03-09 02:05:04.067747, /home/brokenquark/repo-ansi/UXE@edx-configuration/playbooks/edx-east/ora2.yml,3,0,0,0,0,0,3
2019-03-09 02:05:04.113164, /home/brokenquark/repo-ansi/UXE@edx-configuration/playbooks/edx-east/create_dbs.yml,4,0,0,0,0,0,4
2019-03-09 02:05:04.122849, /home/brokenquark/repo-ansi/UXE@edx-configuration/playbooks/secure_example/vars/edxapp_ref_custom_vars.yml,2,0,0,0,0,0,2
2019-03-09 02:05:04.157531, /home/brokenquark/repo-ansi/UXE@edx-configuration/playbooks/secure_example/vars/edxapp_ref_vars.yml,34,0,0,0,0,0,34
2019-03-09 02:05:04.160406, /home/brokenquark/repo-ansi/UXE@edx-configuration/playbooks/secure_example/vars/edxapp_ref_users.yml,2,0,0,0,0,0,2
2019-03-09 02:05:04.163986, /home/brokenquark/repo-ansi/UXE@edx-configuration/playbooks/secure_example/vars/gerrit.yml,7,0,0,0,0,0,7
2019-03-09 02:05:05.324251, /home/brokenquark/repo-ansi/VaneCloud@openstack-ansible/rpc_deployment/playbooks/deprecated.yml,1,0,0,0,0,0,1
2019-03-09 02:05:05.326486, /home/brokenquark/repo-ansi/VaneCloud@openstack-ansible/rpc_deployment/playbooks/deprecated/deprecated.yml,1,0,0,0,0,0,1
2019-03-09 02:05:05.337567, /home/brokenquark/repo-ansi/VaneCloud@openstack-ansible/playbooks/memcached-install.yml,1,0,0,0,0,0,1
2019-03-09 02:05:05.343252, /home/brokenquark/repo-ansi/VaneCloud@openstack-ansible/playbooks/repo-clone-mirror.yml,1,0,0,0,0,0,1
2019-03-09 02:05:05.345754, /home/brokenquark/repo-ansi/VaneCloud@openstack-ansible/playbooks/openstack-hosts-setup.yml,1,0,0,0,0,0,1
2019-03-09 02:05:05.350035, /home/brokenquark/repo-ansi/VaneCloud@openstack-ansible/playbooks/repo-store-source.yml,1,0,0,0,0,0,1
2019-03-09 02:05:05.360303, /home/brokenquark/repo-ansi/VaneCloud@openstack-ansible/playbooks/rabbitmq-install.yml,1,0,0,0,0,0,1
2019-03-09 02:05:05.376574, /home/brokenquark/repo-ansi/VaneCloud@openstack-ansible/playbooks/os-keystone-install.yml,1,0,0,0,0,0,1
2019-03-09 02:05:05.393813, /home/brokenquark/repo-ansi/VaneCloud@openstack-ansible/playbooks/os-glance-install.yml,1,0,0,0,0,0,1
2019-03-09 02:05:05.423280, /home/brokenquark/repo-ansi/VaneCloud@openstack-ansible/playbooks/os-nova-install.yml,1,0,0,0,0,0,1
2019-03-09 02:05:05.427293, /home/brokenquark/repo-ansi/VaneCloud@openstack-ansible/playbooks/os-swift-sync.yml,1,0,0,0,0,0,1
2019-03-09 02:05:05.440708, /home/brokenquark/repo-ansi/VaneCloud@openstack-ansible/playbooks/os-swift-setup.yml,2,0,0,0,0,0,2
2019-03-09 02:05:05.445815, /home/brokenquark/repo-ansi/VaneCloud@openstack-ansible/playbooks/os-tempest-install.yml,1,0,0,0,0,0,1
2019-03-09 02:05:05.460974, /home/brokenquark/repo-ansi/VaneCloud@openstack-ansible/playbooks/repo-build.yml,1,0,0,0,0,0,1
2019-03-09 02:05:05.478582, /home/brokenquark/repo-ansi/VaneCloud@openstack-ansible/playbooks/os-horizon-install.yml,1,0,0,0,0,0,1
2019-03-09 02:05:05.492046, /home/brokenquark/repo-ansi/VaneCloud@openstack-ansible/playbooks/os-ceilometer-install.yml,1,0,0,0,0,0,1
2019-03-09 02:05:05.510689, /home/brokenquark/repo-ansi/VaneCloud@openstack-ansible/playbooks/galera-install.yml,1,0,0,0,0,0,1
2019-03-09 02:05:05.536374, /home/brokenquark/repo-ansi/VaneCloud@openstack-ansible/playbooks/os-cinder-install.yml,1,0,0,0,0,0,1
2019-03-09 02:05:05.553373, /home/brokenquark/repo-ansi/VaneCloud@openstack-ansible/playbooks/utility-install.yml,3,0,0,0,0,0,3
2019-03-09 02:05:05.565974, /home/brokenquark/repo-ansi/VaneCloud@openstack-ansible/playbooks/rsyslog-install.yml,1,0,0,0,0,0,1
2019-03-09 02:05:05.586468, /home/brokenquark/repo-ansi/VaneCloud@openstack-ansible/playbooks/os-neutron-install.yml,1,0,0,0,0,0,1
2019-03-09 02:05:05.600723, /home/brokenquark/repo-ansi/VaneCloud@openstack-ansible/playbooks/os-heat-install.yml,1,0,0,0,0,0,1
2019-03-09 02:05:05.606016, /home/brokenquark/repo-ansi/VaneCloud@openstack-ansible/playbooks/lxc-containers-destroy.yml,1,0,0,0,0,0,1
2019-03-09 02:05:05.614256, /home/brokenquark/repo-ansi/VaneCloud@openstack-ansible/playbooks/haproxy-install.yml,1,0,0,0,0,0,1
2019-03-09 02:05:05.619324, /home/brokenquark/repo-ansi/VaneCloud@openstack-ansible/playbooks/lxc-containers-create.yml,1,0,0,0,0,0,1
2019-03-09 02:05:05.623677, /home/brokenquark/repo-ansi/VaneCloud@openstack-ansible/playbooks/lxc-hosts-setup.yml,1,0,0,0,0,0,1
2019-03-09 02:05:05.633699, /home/brokenquark/repo-ansi/VaneCloud@openstack-ansible/playbooks/repo-server.yml,1,0,0,0,0,0,1
2019-03-09 02:05:05.661344, /home/brokenquark/repo-ansi/VaneCloud@openstack-ansible/playbooks/vars/configs/haproxy_config.yml,1,0,0,0,0,0,1
2019-03-09 02:05:05.691634, /home/brokenquark/repo-ansi/VaneCloud@openstack-ansible/playbooks/roles/lxc_hosts/defaults/main.yml,4,0,0,0,0,0,4
2019-03-09 02:05:05.704621, /home/brokenquark/repo-ansi/VaneCloud@openstack-ansible/playbooks/roles/lxc_hosts/tasks/lxc_pre_install.yml,1,0,0,0,0,0,1
2019-03-09 02:05:05.755370, /home/brokenquark/repo-ansi/VaneCloud@openstack-ansible/playbooks/roles/system_crontab_coordination/tasks/main.yml,1,0,0,0,0,0,1
2019-03-09 02:05:05.777424, /home/brokenquark/repo-ansi/VaneCloud@openstack-ansible/playbooks/roles/os_swift/defaults/main.yml,5,0,0,0,0,0,5
2019-03-09 02:05:05.817257, /home/brokenquark/repo-ansi/VaneCloud@openstack-ansible/playbooks/roles/os_swift/tasks/swift_pre_install.yml,5,0,0,0,0,0,5
2019-03-09 02:05:05.875471, /home/brokenquark/repo-ansi/VaneCloud@openstack-ansible/playbooks/roles/os_swift/tasks/swift_upstart_common_init.yml,1,0,0,0,0,0,1
2019-03-09 02:05:05.894293, /home/brokenquark/repo-ansi/VaneCloud@openstack-ansible/playbooks/roles/os_swift/tasks/swift_storage_hosts_setup.yml,2,0,0,0,0,0,2
2019-03-09 02:05:05.960253, /home/brokenquark/repo-ansi/VaneCloud@openstack-ansible/playbooks/roles/memcached_server/defaults/main.yml,1,0,0,0,0,0,1
2019-03-09 02:05:05.967324, /home/brokenquark/repo-ansi/VaneCloud@openstack-ansible/playbooks/roles/memcached_server/tasks/memcached_config.yml,2,0,0,0,0,0,2
2019-03-09 02:05:05.999004, /home/brokenquark/repo-ansi/VaneCloud@openstack-ansible/playbooks/roles/os_glance/defaults/main.yml,5,0,0,2,0,0,7
2019-03-09 02:05:06.004366, /home/brokenquark/repo-ansi/VaneCloud@openstack-ansible/playbooks/roles/os_glance/tasks/glance_upstart_common_init.yml,1,0,0,0,0,0,1
2019-03-09 02:05:06.032114, /home/brokenquark/repo-ansi/VaneCloud@openstack-ansible/playbooks/roles/os_glance/tasks/glance_pre_install.yml,1,0,0,0,0,0,1
2019-03-09 02:05:06.067435, /home/brokenquark/repo-ansi/VaneCloud@openstack-ansible/playbooks/roles/os_glance/tasks/glance_post_install.yml,1,0,0,0,0,0,1
2019-03-09 02:05:06.102674, /home/brokenquark/repo-ansi/VaneCloud@openstack-ansible/playbooks/roles/galera_client/defaults/main.yml,2,0,0,0,0,0,2
2019-03-09 02:05:06.117549, /home/brokenquark/repo-ansi/VaneCloud@openstack-ansible/playbooks/roles/galera_client/tasks/galera_client_post_install.yml,1,0,0,0,0,0,1
2019-03-09 02:05:06.136219, /home/brokenquark/repo-ansi/VaneCloud@openstack-ansible/playbooks/roles/openstack_hosts/defaults/main.yml,20,0,0,0,0,0,20
2019-03-09 02:05:06.144734, /home/brokenquark/repo-ansi/VaneCloud@openstack-ansible/playbooks/roles/openstack_hosts/tasks/openstack_lvm_config.yml,1,0,0,0,0,0,1
2019-03-09 02:05:06.180059, /home/brokenquark/repo-ansi/VaneCloud@openstack-ansible/playbooks/roles/openstack_hosts/tasks/openstack_release.yml,1,0,0,0,0,0,1
2019-03-09 02:05:06.193694, /home/brokenquark/repo-ansi/VaneCloud@openstack-ansible/playbooks/roles/os_swift_sync/defaults/main.yml,1,0,0,0,0,0,1
2019-03-09 02:05:06.213731, /home/brokenquark/repo-ansi/VaneCloud@openstack-ansible/playbooks/roles/os_swift_sync/tasks/swift_rings_distribute.yml,2,0,0,0,0,0,2
2019-03-09 02:05:06.296747, /home/brokenquark/repo-ansi/VaneCloud@openstack-ansible/playbooks/roles/os_nova/defaults/main.yml,10,0,0,0,0,0,10
2019-03-09 02:05:06.322630, /home/brokenquark/repo-ansi/VaneCloud@openstack-ansible/playbooks/roles/os_nova/tasks/nova_pre_install.yml,4,0,0,0,0,0,4
2019-03-09 02:05:06.433374, /home/brokenquark/repo-ansi/VaneCloud@openstack-ansible/playbooks/roles/os_nova/tasks/nova_upstart_common_init.yml,1,0,0,0,0,0,1
2019-03-09 02:05:06.451972, /home/brokenquark/repo-ansi/VaneCloud@openstack-ansible/playbooks/roles/os_horizon/defaults/main.yml,7,0,1,0,0,0,8
2019-03-09 02:05:06.482929, /home/brokenquark/repo-ansi/VaneCloud@openstack-ansible/playbooks/roles/os_horizon/tasks/horizon_apache.yml,1,0,0,0,0,0,1
2019-03-09 02:05:06.525325, /home/brokenquark/repo-ansi/VaneCloud@openstack-ansible/playbooks/roles/os_horizon/tasks/horizon_ssl_user_provided.yml,2,0,0,0,0,0,2
2019-03-09 02:05:06.544400, /home/brokenquark/repo-ansi/VaneCloud@openstack-ansible/playbooks/roles/rabbitmq_server/defaults/main.yml,5,0,0,0,0,1,6
2019-03-09 02:05:06.555743, /home/brokenquark/repo-ansi/VaneCloud@openstack-ansible/playbooks/roles/rabbitmq_server/tasks/rabbitmq_post_install.yml,2,0,0,0,1,0,3
2019-03-09 02:05:06.562686, /home/brokenquark/repo-ansi/VaneCloud@openstack-ansible/playbooks/roles/rabbitmq_server/tasks/rabbitmq_ssl_key_distribute.yml,1,0,0,0,1,0,2
2019-03-09 02:05:06.572533, /home/brokenquark/repo-ansi/VaneCloud@openstack-ansible/playbooks/roles/rabbitmq_server/tasks/rabbitmq_ssl_user_provided.yml,2,0,0,0,0,0,2
2019-03-09 02:05:06.577769, /home/brokenquark/repo-ansi/VaneCloud@openstack-ansible/playbooks/roles/rabbitmq_server/tasks/rabbitmq_set_cookie.yml,1,0,0,0,0,0,1
2019-03-09 02:05:06.605779, /home/brokenquark/repo-ansi/VaneCloud@openstack-ansible/playbooks/roles/rabbitmq_server/tasks/rabbitmq_ssl_key_create.yml,1,0,0,0,0,0,1
2019-03-09 02:05:06.638909, /home/brokenquark/repo-ansi/VaneCloud@openstack-ansible/playbooks/roles/openstack_openrc/defaults/main.yml,1,0,0,0,0,0,1
2019-03-09 02:05:06.677724, /home/brokenquark/repo-ansi/VaneCloud@openstack-ansible/playbooks/roles/os_keystone/defaults/main.yml,7,0,0,1,0,0,8
2019-03-09 02:05:06.698659, /home/brokenquark/repo-ansi/VaneCloud@openstack-ansible/playbooks/roles/os_keystone/tasks/keystone_pre_install.yml,4,0,0,0,0,0,4
2019-03-09 02:05:06.717085, /home/brokenquark/repo-ansi/VaneCloud@openstack-ansible/playbooks/roles/os_keystone/tasks/keystone_ssl_user_provided.yml,2,0,0,0,0,0,2
2019-03-09 02:05:06.737111, /home/brokenquark/repo-ansi/VaneCloud@openstack-ansible/playbooks/roles/os_keystone/tasks/keystone_federation_sp_setup.yml,1,0,0,0,0,0,1
2019-03-09 02:05:06.778229, /home/brokenquark/repo-ansi/VaneCloud@openstack-ansible/playbooks/roles/os_keystone/tasks/keystone_apache.yml,1,0,0,0,0,0,1
2019-03-09 02:05:06.943319, /home/brokenquark/repo-ansi/VaneCloud@openstack-ansible/playbooks/roles/os_keystone/tasks/keystone_fernet_keys_autorotate.yml,1,0,0,0,0,0,1
2019-03-09 02:05:06.962602, /home/brokenquark/repo-ansi/VaneCloud@openstack-ansible/playbooks/roles/lxc_container_create/defaults/main.yml,1,0,0,0,0,0,1
2019-03-09 02:05:06.996705, /home/brokenquark/repo-ansi/VaneCloud@openstack-ansible/playbooks/roles/lxc_container_create/tasks/container_create.yml,2,0,0,0,2,0,4
2019-03-09 02:05:07.014054, /home/brokenquark/repo-ansi/VaneCloud@openstack-ansible/playbooks/roles/haproxy_server/defaults/main.yml,7,0,1,0,0,0,8
2019-03-09 02:05:07.037476, /home/brokenquark/repo-ansi/VaneCloud@openstack-ansible/playbooks/roles/haproxy_server/tasks/haproxy_ssl_configuration.yml,2,0,0,0,0,0,2
2019-03-09 02:05:07.075684, /home/brokenquark/repo-ansi/VaneCloud@openstack-ansible/playbooks/roles/os_heat/defaults/main.yml,5,0,0,0,0,0,5
2019-03-09 02:05:07.081719, /home/brokenquark/repo-ansi/VaneCloud@openstack-ansible/playbooks/roles/os_heat/tasks/heat_upstart_common_init.yml,1,0,0,0,0,0,1
2019-03-09 02:05:07.141346, /home/brokenquark/repo-ansi/VaneCloud@openstack-ansible/playbooks/roles/os_heat/tasks/heat_pre_install.yml,1,0,0,0,0,0,1
2019-03-09 02:05:07.188101, /home/brokenquark/repo-ansi/VaneCloud@openstack-ansible/playbooks/roles/ceph_client/defaults/main.yml,3,0,0,0,0,0,3
2019-03-09 02:05:07.200142, /home/brokenquark/repo-ansi/VaneCloud@openstack-ansible/playbooks/roles/ceph_client/tasks/ceph_config.yml,2,0,0,0,0,0,2
2019-03-09 02:05:07.231784, /home/brokenquark/repo-ansi/VaneCloud@openstack-ansible/playbooks/roles/ceph_client/tasks/ceph_auth.yml,1,0,0,0,0,0,1
2019-03-09 02:05:07.258216, /home/brokenquark/repo-ansi/VaneCloud@openstack-ansible/playbooks/roles/galera_server/defaults/main.yml,3,1,0,0,1,0,5
2019-03-09 02:05:07.271542, /home/brokenquark/repo-ansi/VaneCloud@openstack-ansible/playbooks/roles/galera_server/tasks/galera_post_install.yml,3,0,0,0,0,0,3
2019-03-09 02:05:07.316161, /home/brokenquark/repo-ansi/VaneCloud@openstack-ansible/playbooks/roles/os_ceilometer/defaults/main.yml,3,0,0,1,0,0,4
2019-03-09 02:05:07.350646, /home/brokenquark/repo-ansi/VaneCloud@openstack-ansible/playbooks/roles/os_ceilometer/tasks/ceilometer_pre_install.yml,1,0,0,0,0,0,1
2019-03-09 02:05:07.358611, /home/brokenquark/repo-ansi/VaneCloud@openstack-ansible/playbooks/roles/os_ceilometer/tasks/ceilometer_upstart_common_init.yml,1,0,0,0,0,0,1
2019-03-09 02:05:07.437427, /home/brokenquark/repo-ansi/VaneCloud@openstack-ansible/playbooks/roles/os_neutron/defaults/main.yml,6,0,0,0,0,0,6
2019-03-09 02:05:07.483228, /home/brokenquark/repo-ansi/VaneCloud@openstack-ansible/playbooks/roles/os_neutron/tasks/neutron_upstart_common_init.yml,1,0,0,0,0,0,1
2019-03-09 02:05:07.504677, /home/brokenquark/repo-ansi/VaneCloud@openstack-ansible/playbooks/roles/os_neutron/tasks/neutron_post_install.yml,1,0,0,0,0,0,1
2019-03-09 02:05:07.525503, /home/brokenquark/repo-ansi/VaneCloud@openstack-ansible/playbooks/roles/os_neutron/tasks/neutron_l3_ha.yml,3,0,0,0,0,0,3
2019-03-09 02:05:07.542005, /home/brokenquark/repo-ansi/VaneCloud@openstack-ansible/playbooks/roles/os_neutron/tasks/neutron_pre_install.yml,2,0,0,0,0,0,2
2019-03-09 02:05:07.565125, /home/brokenquark/repo-ansi/VaneCloud@openstack-ansible/playbooks/roles/rsyslog_server/tasks/rsyslog_server_post_install.yml,2,0,0,0,0,0,2
2019-03-09 02:05:07.567961, /home/brokenquark/repo-ansi/VaneCloud@openstack-ansible/playbooks/roles/rsyslog_server/tasks/rsyslog_server_pre_install.yml,1,0,0,0,0,0,1
2019-03-09 02:05:07.586508, /home/brokenquark/repo-ansi/VaneCloud@openstack-ansible/playbooks/roles/os_tempest/defaults/main.yml,6,0,1,0,0,0,7
2019-03-09 02:05:07.641843, /home/brokenquark/repo-ansi/VaneCloud@openstack-ansible/playbooks/roles/os_tempest/tasks/tempest_post_install.yml,3,0,0,0,0,0,3
2019-03-09 02:05:07.664345, /home/brokenquark/repo-ansi/VaneCloud@openstack-ansible/playbooks/roles/repo_server/defaults/main.yml,1,0,0,0,0,0,1
2019-03-09 02:05:07.697892, /home/brokenquark/repo-ansi/VaneCloud@openstack-ansible/playbooks/roles/repo_server/tasks/repo_pre_install.yml,1,0,0,0,0,0,1
2019-03-09 02:05:07.741132, /home/brokenquark/repo-ansi/VaneCloud@openstack-ansible/playbooks/roles/repo_server/tasks/repo_post_install.yml,2,0,0,0,0,0,2
2019-03-09 02:05:07.807902, /home/brokenquark/repo-ansi/VaneCloud@openstack-ansible/playbooks/roles/os_cinder/defaults/main.yml,7,0,0,0,0,0,7
2019-03-09 02:05:07.825302, /home/brokenquark/repo-ansi/VaneCloud@openstack-ansible/playbooks/roles/os_cinder/tasks/cinder_pre_install.yml,2,0,0,0,0,0,2
2019-03-09 02:05:07.832247, /home/brokenquark/repo-ansi/VaneCloud@openstack-ansible/playbooks/roles/os_cinder/tasks/cinder_lvm_config.yml,1,0,0,0,0,0,1
2019-03-09 02:05:07.847352, /home/brokenquark/repo-ansi/VaneCloud@openstack-ansible/playbooks/roles/os_cinder/tasks/cinder_upstart_common_init.yml,1,0,0,0,0,0,1
2019-03-09 02:05:07.927988, /home/brokenquark/repo-ansi/VaneCloud@openstack-ansible/playbooks/roles/rsyslog_client/tasks/rsyslog_client_pre_install.yml,1,0,0,0,0,0,1
2019-03-09 02:05:07.939419, /home/brokenquark/repo-ansi/VaneCloud@openstack-ansible/playbooks/roles/rsyslog_client/tasks/rsyslog_client_post_install.yml,2,0,0,0,0,0,2
2019-03-09 02:05:07.980859, /home/brokenquark/repo-ansi/VaneCloud@openstack-ansible/playbooks/inventory/group_vars/all_containers.yml,16,0,0,0,0,0,16
2019-03-09 02:05:08.011227, /home/brokenquark/repo-ansi/VaneCloud@openstack-ansible/playbooks/inventory/group_vars/hosts.yml,16,0,0,0,0,0,16
2019-03-09 02:05:08.330454, /home/brokenquark/repo-ansi/VaneCloud@openstack-ansible/scripts/upgrade-utilities/playbooks/swift-repo-adjustments.yml,1,0,0,0,0,0,1
2019-03-09 02:05:08.334913, /home/brokenquark/repo-ansi/VaneCloud@openstack-ansible/scripts/upgrade-utilities/playbooks/nova-extra-migrations.yml,1,0,0,0,0,0,1
2019-03-09 02:05:08.339087, /home/brokenquark/repo-ansi/VaneCloud@openstack-ansible/scripts/upgrade-utilities/playbooks/container-network-adjustments.yml,1,0,0,0,0,0,1
2019-03-09 02:05:08.343662, /home/brokenquark/repo-ansi/VaneCloud@openstack-ansible/scripts/upgrade-utilities/playbooks/user-secrets-adjustments.yml,1,0,0,0,0,0,1
2019-03-09 02:05:08.346596, /home/brokenquark/repo-ansi/VaneCloud@openstack-ansible/scripts/upgrade-utilities/playbooks/keystone-adjustments.yml,1,0,0,0,0,0,1
2019-03-09 02:05:08.358335, /home/brokenquark/repo-ansi/VaneCloud@openstack-ansible/scripts/upgrade-utilities/playbooks/host-adjustments.yml,1,0,0,0,0,0,1
2019-03-09 02:05:08.367359, /home/brokenquark/repo-ansi/VaneCloud@openstack-ansible/scripts/upgrade-utilities/playbooks/swift-ring-adjustments.yml,2,0,0,0,0,0,2
2019-03-09 02:05:08.372649, /home/brokenquark/repo-ansi/VaneCloud@openstack-ansible/scripts/upgrade-utilities/playbooks/cinder-adjustments.yml,1,0,0,0,0,0,1
2019-03-09 02:05:08.378089, /home/brokenquark/repo-ansi/VaneCloud@openstack-ansible/scripts/upgrade-utilities/playbooks/horizon-adjustments.yml,2,0,0,0,0,0,2
2019-03-09 02:05:08.381555, /home/brokenquark/repo-ansi/VaneCloud@openstack-ansible/scripts/upgrade-utilities/playbooks/container-network-bounce.yml,1,0,0,0,0,0,1
2019-03-09 02:05:08.385176, /home/brokenquark/repo-ansi/VaneCloud@openstack-ansible/scripts/upgrade-utilities/playbooks/remove-juno-log-rotate.yml,1,0,0,0,0,0,1
2019-03-09 02:05:33.795295, /home/brokenquark/repo-ansi/antshin72@configuration/playbooks/roles/jenkins_master/defaults/main.yml,1,0,1,0,0,0,2
2019-03-09 02:05:33.818095, /home/brokenquark/repo-ansi/antshin72@configuration/playbooks/roles/jenkins_master/tasks/main.yml,0,0,0,0,4,0,4
2019-03-09 02:05:33.833794, /home/brokenquark/repo-ansi/antshin72@configuration/playbooks/roles/common/defaults/main.yml,11,1,2,0,0,0,14
2019-03-09 02:05:33.846802, /home/brokenquark/repo-ansi/antshin72@configuration/playbooks/roles/common/tasks/main.yml,0,0,0,0,1,0,1
2019-03-09 02:05:33.869226, /home/brokenquark/repo-ansi/antshin72@configuration/playbooks/roles/harprofiler/defaults/main.yml,1,0,0,0,0,0,1
2019-03-09 02:05:33.919721, /home/brokenquark/repo-ansi/antshin72@configuration/playbooks/roles/edx_service_rds/defaults/main.yml,2,0,0,4,0,0,6
2019-03-09 02:05:33.972822, /home/brokenquark/repo-ansi/antshin72@configuration/playbooks/roles/newrelic-npi/defaults/main.yml,1,0,0,0,0,0,1
2019-03-09 02:05:33.993977, /home/brokenquark/repo-ansi/antshin72@configuration/playbooks/roles/xserver/defaults/main.yml,2,0,0,0,0,0,2
2019-03-09 02:05:34.025720, /home/brokenquark/repo-ansi/antshin72@configuration/playbooks/roles/test_build_server/defaults/main.yml,1,0,0,0,0,0,1
2019-03-09 02:05:34.041855, /home/brokenquark/repo-ansi/antshin72@configuration/playbooks/roles/aws/defaults/main.yml,3,0,1,0,1,1,6
2019-03-09 02:05:34.055868, /home/brokenquark/repo-ansi/antshin72@configuration/playbooks/roles/aws/tasks/main.yml,1,0,0,0,2,0,3
2019-03-09 02:05:34.068207, /home/brokenquark/repo-ansi/antshin72@configuration/playbooks/roles/forum/defaults/main.yml,3,0,0,1,0,0,4
2019-03-09 02:05:34.101066, /home/brokenquark/repo-ansi/antshin72@configuration/playbooks/roles/hadoop_common/defaults/main.yml,1,0,0,0,0,0,1
2019-03-09 02:05:34.119450, /home/brokenquark/repo-ansi/antshin72@configuration/playbooks/roles/hadoop_common/tasks/main.yml,1,0,0,0,0,0,1
2019-03-09 02:05:34.144121, /home/brokenquark/repo-ansi/antshin72@configuration/playbooks/roles/ora/defaults/main.yml,7,0,0,0,0,0,7
2019-03-09 02:05:34.171051, /home/brokenquark/repo-ansi/antshin72@configuration/playbooks/roles/redis/defaults/main.yml,1,1,0,0,0,0,2
2019-03-09 02:05:34.179072, /home/brokenquark/repo-ansi/antshin72@configuration/playbooks/roles/elasticsearch/defaults/main.yml,1,0,0,0,0,0,1
2019-03-09 02:05:34.196599, /home/brokenquark/repo-ansi/antshin72@configuration/playbooks/roles/antivirus/defaults/main.yml,1,0,0,0,0,0,1
2019-03-09 02:05:34.221476, /home/brokenquark/repo-ansi/antshin72@configuration/playbooks/roles/flower/defaults/main.yml,4,0,0,1,0,0,5
2019-03-09 02:05:34.234413, /home/brokenquark/repo-ansi/antshin72@configuration/playbooks/roles/gh_mirror/defaults/main.yml,1,0,0,0,0,0,1
2019-03-09 02:05:34.245288, /home/brokenquark/repo-ansi/antshin72@configuration/playbooks/roles/sqoop/defaults/main.yml,0,0,2,0,0,0,2
2019-03-09 02:05:34.261994, /home/brokenquark/repo-ansi/antshin72@configuration/playbooks/roles/elasticsearch-monitor/tasks/main.yml,1,0,0,0,0,0,1
2019-03-09 02:05:34.267254, /home/brokenquark/repo-ansi/antshin72@configuration/playbooks/roles/devpi/defaults/main.yml,2,0,0,0,0,0,2
2019-03-09 02:05:34.302516, /home/brokenquark/repo-ansi/antshin72@configuration/playbooks/roles/user/defaults/main.yml,0,0,0,0,1,0,1
2019-03-09 02:05:34.340682, /home/brokenquark/repo-ansi/antshin72@configuration/playbooks/roles/ecommerce/defaults/main.yml,6,0,0,0,0,0,6
2019-03-09 02:05:34.364909, /home/brokenquark/repo-ansi/antshin72@configuration/playbooks/roles/newrelic/tasks/newrelic-logwatcher.yml,1,0,0,0,0,0,1
2019-03-09 02:05:34.384085, /home/brokenquark/repo-ansi/antshin72@configuration/playbooks/roles/newrelic/meta/main.yml,2,0,0,0,0,0,2
2019-03-09 02:05:34.394826, /home/brokenquark/repo-ansi/antshin72@configuration/playbooks/roles/alton/defaults/main.yml,6,0,0,0,0,0,6
2019-03-09 02:05:34.438611, /home/brokenquark/repo-ansi/antshin72@configuration/playbooks/roles/gluster/tasks/main.yml,0,0,0,0,1,0,1
2019-03-09 02:05:34.451010, /home/brokenquark/repo-ansi/antshin72@configuration/playbooks/roles/certs/defaults/main.yml,4,0,0,0,0,0,4
2019-03-09 02:05:34.482717, /home/brokenquark/repo-ansi/antshin72@configuration/playbooks/roles/demo/defaults/main.yml,6,0,0,0,0,0,6
2019-03-09 02:05:34.493440, /home/brokenquark/repo-ansi/antshin72@configuration/playbooks/roles/oraclejdk/defaults/main.yml,0,0,1,0,0,0,1
2019-03-09 02:05:34.505082, /home/brokenquark/repo-ansi/antshin72@configuration/playbooks/roles/splunkforwarder/defaults/main.yml,0,1,0,0,0,0,1
2019-03-09 02:05:34.516088, /home/brokenquark/repo-ansi/antshin72@configuration/playbooks/roles/splunkforwarder/tasks/main.yml,1,0,0,0,0,0,1
2019-03-09 02:05:34.534036, /home/brokenquark/repo-ansi/antshin72@configuration/playbooks/roles/notifier/defaults/main.yml,2,2,0,0,0,0,4
2019-03-09 02:05:34.568033, /home/brokenquark/repo-ansi/antshin72@configuration/playbooks/roles/edx_ansible/defaults/main.yml,1,0,0,0,0,0,1
2019-03-09 02:05:34.592112, /home/brokenquark/repo-ansi/antshin72@configuration/playbooks/roles/snort/defaults/main.yml,0,0,2,0,0,1,3
2019-03-09 02:05:34.612168, /home/brokenquark/repo-ansi/antshin72@configuration/playbooks/roles/mariadb/defaults/main.yml,3,0,0,0,0,0,3
2019-03-09 02:05:34.652377, /home/brokenquark/repo-ansi/antshin72@configuration/playbooks/roles/minos/meta/main.yml,1,0,0,0,0,0,1
2019-03-09 02:05:34.672375, /home/brokenquark/repo-ansi/antshin72@configuration/playbooks/roles/gitreload/defaults/main.yml,1,0,0,0,0,0,1
2019-03-09 02:05:34.699065, /home/brokenquark/repo-ansi/antshin72@configuration/playbooks/roles/locust/defaults/main.yml,1,0,0,0,0,0,1
2019-03-09 02:05:34.714820, /home/brokenquark/repo-ansi/antshin72@configuration/playbooks/roles/s3fs/defaults/main.yml,0,0,1,0,0,0,1
2019-03-09 02:05:34.728125, /home/brokenquark/repo-ansi/antshin72@configuration/playbooks/roles/mongo/defaults/main.yml,7,0,1,0,0,0,8
2019-03-09 02:05:34.902330, /home/brokenquark/repo-ansi/antshin72@configuration/playbooks/roles/edxapp/defaults/main.yml,16,1,2,0,1,0,20
2019-03-09 02:05:34.971443, /home/brokenquark/repo-ansi/antshin72@configuration/playbooks/roles/edxapp/tasks/deploy.yml,0,0,0,0,3,0,3
2019-03-09 02:05:35.016391, /home/brokenquark/repo-ansi/antshin72@configuration/playbooks/roles/edx_notes_api/defaults/main.yml,3,0,0,0,0,0,3
2019-03-09 02:05:35.056452, /home/brokenquark/repo-ansi/antshin72@configuration/playbooks/roles/rabbitmq/defaults/main.yml,5,0,2,0,0,1,8
2019-03-09 02:05:35.073493, /home/brokenquark/repo-ansi/antshin72@configuration/playbooks/roles/rabbitmq/tasks/main.yml,1,0,0,0,1,0,2
2019-03-09 02:05:35.079442, /home/brokenquark/repo-ansi/antshin72@configuration/playbooks/roles/analytics_pipeline/defaults/main.yml,2,0,0,0,0,0,2
2019-03-09 02:05:35.116520, /home/brokenquark/repo-ansi/antshin72@configuration/playbooks/roles/insights/defaults/main.yml,7,0,1,0,0,0,8
2019-03-09 02:05:35.138100, /home/brokenquark/repo-ansi/antshin72@configuration/playbooks/roles/sitespeedio/tasks/main.yml,0,0,0,0,1,0,1
2019-03-09 02:05:35.144723, /home/brokenquark/repo-ansi/antshin72@configuration/playbooks/roles/supervisor/defaults/main.yml,1,0,0,0,0,0,1
2019-03-09 02:05:35.164360, /home/brokenquark/repo-ansi/antshin72@configuration/playbooks/roles/browsers/defaults/main.yml,0,0,1,0,0,1,2
2019-03-09 02:05:35.177419, /home/brokenquark/repo-ansi/antshin72@configuration/playbooks/roles/nltk/defaults/main.yml,0,0,3,0,0,3,6
2019-03-09 02:05:35.195197, /home/brokenquark/repo-ansi/antshin72@configuration/playbooks/roles/analytics_api/defaults/main.yml,8,0,0,0,0,0,8
2019-03-09 02:05:35.280439, /home/brokenquark/repo-ansi/antshin72@configuration/playbooks/roles/mongo_3_0/defaults/main.yml,7,0,0,0,0,0,7
2019-03-09 02:05:35.351434, /home/brokenquark/repo-ansi/antshin72@configuration/playbooks/roles/jenkins_worker/defaults/main.yml,1,0,0,0,0,1,2
2019-03-09 02:05:35.361720, /home/brokenquark/repo-ansi/antshin72@configuration/playbooks/roles/jenkins_worker/tasks/system.yml,0,0,0,0,2,0,2
2019-03-09 02:05:35.394602, /home/brokenquark/repo-ansi/antshin72@configuration/playbooks/roles/datadog/defaults/main.yml,1,0,0,0,0,0,1
2019-03-09 02:05:35.416692, /home/brokenquark/repo-ansi/antshin72@configuration/playbooks/roles/xqueue/defaults/main.yml,5,0,0,0,0,0,5
2019-03-09 02:05:35.463662, /home/brokenquark/repo-ansi/antshin72@configuration/playbooks/roles/nginx/defaults/main.yml,2,0,0,0,0,0,2
2019-03-09 02:05:35.493722, /home/brokenquark/repo-ansi/antshin72@configuration/playbooks/roles/shibboleth/defaults/main.yml,3,0,1,0,0,0,4
2019-03-09 02:05:35.509657, /home/brokenquark/repo-ansi/antshin72@configuration/playbooks/roles/jscover/defaults/main.yml,0,0,1,0,0,0,1
2019-03-09 02:05:35.547054, /home/brokenquark/repo-ansi/antshin72@configuration/playbooks/roles/hive/defaults/main.yml,2,0,1,0,0,0,3
2019-03-09 02:05:35.568462, /home/brokenquark/repo-ansi/antshin72@configuration/playbooks/roles/local_dev/defaults/main.yml,1,0,0,0,0,0,1
2019-03-09 02:05:35.583881, /home/brokenquark/repo-ansi/antshin72@configuration/playbooks/roles/cassandra/defaults/main.yml,1,0,0,0,0,0,1
2019-03-09 02:05:35.594771, /home/brokenquark/repo-ansi/antshin72@configuration/playbooks/roles/cassandra/tasks/main.yml,0,0,1,0,0,0,1
2019-03-09 02:05:35.629755, /home/brokenquark/repo-ansi/antshin72@configuration/playbooks/edx-west/stage-worker.yml,1,0,0,0,0,0,1
2019-03-09 02:05:35.701151, /home/brokenquark/repo-ansi/antshin72@configuration/playbooks/edx-west/stage-notifier-only.yml,1,0,0,0,0,0,1
2019-03-09 02:05:35.888886, /home/brokenquark/repo-ansi/antshin72@configuration/playbooks/edx-east/edx_provision.yml,3,0,0,0,0,0,3
2019-03-09 02:05:35.903007, /home/brokenquark/repo-ansi/antshin72@configuration/playbooks/edx-east/add-ubuntu-key.yml,1,0,0,0,0,0,1
2019-03-09 02:05:35.950565, /home/brokenquark/repo-ansi/antshin72@configuration/playbooks/edx-east/remove-ubuntu-key.yml,1,0,0,0,0,0,1
2019-03-09 02:05:35.977452, /home/brokenquark/repo-ansi/antshin72@configuration/playbooks/edx-east/edx_notifier.yml,5,0,0,0,0,0,5
2019-03-09 02:05:36.050697, /home/brokenquark/repo-ansi/antshin72@configuration/playbooks/edx-east/edx_service.yml,1,0,0,0,0,0,1
2019-03-09 02:05:36.119826, /home/brokenquark/repo-ansi/antshin72@configuration/playbooks/edx-east/ora2.yml,3,0,0,0,0,0,3
2019-03-09 02:05:55.035319, /home/brokenquark/repo-ansi/atulsian89@Streisand/playbooks/cloud-status.yml,1,0,0,0,0,0,1
2019-03-09 02:05:55.040715, /home/brokenquark/repo-ansi/atulsian89@Streisand/playbooks/streisand.yml,2,0,0,0,0,0,2
2019-03-09 02:05:55.085090, /home/brokenquark/repo-ansi/atulsian89@Streisand/playbooks/roles/common/tasks/main.yml,1,0,0,0,0,0,1
2019-03-09 02:05:55.109641, /home/brokenquark/repo-ansi/atulsian89@Streisand/playbooks/roles/wireguard/tasks/main.yml,2,0,0,0,0,0,2
2019-03-09 02:05:55.149726, /home/brokenquark/repo-ansi/atulsian89@Streisand/playbooks/roles/ec2-security-group/tasks/main.yml,0,0,0,15,0,0,15
2019-03-09 02:05:55.159022, /home/brokenquark/repo-ansi/atulsian89@Streisand/playbooks/roles/streisand-gateway/vars/main.yml,1,0,0,0,0,0,1
2019-03-09 02:05:55.161264, /home/brokenquark/repo-ansi/atulsian89@Streisand/playbooks/roles/streisand-gateway/defaults/main.yml,1,0,0,0,0,0,1
2019-03-09 02:05:55.186821, /home/brokenquark/repo-ansi/atulsian89@Streisand/playbooks/roles/streisand-gateway/tasks/main.yml,4,0,0,0,0,0,4
2019-03-09 02:05:55.195029, /home/brokenquark/repo-ansi/atulsian89@Streisand/playbooks/roles/openconnect/vars/main.yml,1,0,0,0,0,0,1
2019-03-09 02:05:55.224802, /home/brokenquark/repo-ansi/atulsian89@Streisand/playbooks/roles/openconnect/tasks/main.yml,11,0,0,0,0,0,11
2019-03-09 02:05:55.230367, /home/brokenquark/repo-ansi/atulsian89@Streisand/playbooks/roles/rsyslog/tasks/main.yml,1,0,0,0,0,0,1
2019-03-09 02:05:55.248539, /home/brokenquark/repo-ansi/atulsian89@Streisand/playbooks/roles/tor-bridge/tasks/main.yml,4,0,0,0,0,0,4
2019-03-09 02:05:55.250785, /home/brokenquark/repo-ansi/atulsian89@Streisand/playbooks/roles/ssh/vars/main.yml,1,0,0,0,0,0,1
2019-03-09 02:05:55.263058, /home/brokenquark/repo-ansi/atulsian89@Streisand/playbooks/roles/ssh/tasks/main.yml,6,0,0,0,0,0,6
2019-03-09 02:05:55.265478, /home/brokenquark/repo-ansi/atulsian89@Streisand/playbooks/roles/genesis-amazon/defaults/main.yml,1,0,0,0,0,0,1
2019-03-09 02:05:55.281112, /home/brokenquark/repo-ansi/atulsian89@Streisand/playbooks/roles/genesis-amazon/tasks/main.yml,1,0,0,0,0,0,1
2019-03-09 02:05:55.284116, /home/brokenquark/repo-ansi/atulsian89@Streisand/playbooks/roles/genesis-digitalocean/defaults/main.yml,2,0,0,0,0,0,2
2019-03-09 02:05:55.308617, /home/brokenquark/repo-ansi/atulsian89@Streisand/playbooks/roles/streisand-mirror/vars/stunnel.yml,1,0,0,0,0,0,1
2019-03-09 02:05:55.316055, /home/brokenquark/repo-ansi/atulsian89@Streisand/playbooks/roles/streisand-mirror/vars/openvpn.yml,1,0,1,0,0,0,2
2019-03-09 02:05:55.321679, /home/brokenquark/repo-ansi/atulsian89@Streisand/playbooks/roles/streisand-mirror/vars/ssh.yml,1,0,1,0,0,0,2
2019-03-09 02:05:55.329317, /home/brokenquark/repo-ansi/atulsian89@Streisand/playbooks/roles/streisand-mirror/vars/tor.yml,1,0,0,0,0,0,1
2019-03-09 02:05:55.334311, /home/brokenquark/repo-ansi/atulsian89@Streisand/playbooks/roles/streisand-mirror/tasks/openconnect.yml,2,0,0,0,0,0,2
2019-03-09 02:05:55.340839, /home/brokenquark/repo-ansi/atulsian89@Streisand/playbooks/roles/streisand-mirror/tasks/download-and-verify.yml,1,0,0,0,0,0,1
2019-03-09 02:05:55.345207, /home/brokenquark/repo-ansi/atulsian89@Streisand/playbooks/roles/streisand-mirror/tasks/shadowsocks.yml,2,0,0,0,0,0,2
2019-03-09 02:05:55.350946, /home/brokenquark/repo-ansi/atulsian89@Streisand/playbooks/roles/streisand-mirror/tasks/stunnel.yml,1,0,0,0,0,0,1
2019-03-09 02:05:55.356473, /home/brokenquark/repo-ansi/atulsian89@Streisand/playbooks/roles/streisand-mirror/tasks/openvpn.yml,2,0,0,0,0,0,2
2019-03-09 02:05:55.360608, /home/brokenquark/repo-ansi/atulsian89@Streisand/playbooks/roles/streisand-mirror/tasks/main.yml,1,0,0,0,0,0,1
2019-03-09 02:05:55.366296, /home/brokenquark/repo-ansi/atulsian89@Streisand/playbooks/roles/streisand-mirror/tasks/ssh.yml,2,0,0,0,0,0,2
2019-03-09 02:05:55.372945, /home/brokenquark/repo-ansi/atulsian89@Streisand/playbooks/roles/streisand-mirror/tasks/tor.yml,1,0,0,0,0,0,1
2019-03-09 02:05:55.375245, /home/brokenquark/repo-ansi/atulsian89@Streisand/playbooks/roles/monit/tasks/main.yml,1,0,0,0,0,0,1
2019-03-09 02:05:55.394456, /home/brokenquark/repo-ansi/atulsian89@Streisand/playbooks/roles/l2tp-ipsec/vars/sysctl-values.yml,24,0,0,0,0,0,24
2019-03-09 02:05:55.417694, /home/brokenquark/repo-ansi/atulsian89@Streisand/playbooks/roles/l2tp-ipsec/tasks/main.yml,11,0,0,0,0,0,11
2019-03-09 02:05:55.429705, /home/brokenquark/repo-ansi/atulsian89@Streisand/playbooks/roles/openvpn/vars/main.yml,1,0,0,0,0,0,1
2019-03-09 02:05:55.465735, /home/brokenquark/repo-ansi/atulsian89@Streisand/playbooks/roles/openvpn/tasks/main.yml,4,0,0,0,0,0,4
2019-03-09 02:05:55.481353, /home/brokenquark/repo-ansi/atulsian89@Streisand/playbooks/roles/gce-network/tasks/main.yml,0,0,0,6,0,0,6
2019-03-09 02:05:55.494342, /home/brokenquark/repo-ansi/atulsian89@Streisand/playbooks/roles/genesis-google/tasks/main.yml,1,0,0,0,0,0,1
2019-03-09 02:05:55.502794, /home/brokenquark/repo-ansi/atulsian89@Streisand/playbooks/roles/nginx/tasks/main.yml,2,0,0,0,0,0,2
2019-03-09 02:05:55.504844, /home/brokenquark/repo-ansi/atulsian89@Streisand/playbooks/roles/genesis-linode/defaults/main.yml,1,0,0,0,0,0,1
2019-03-09 02:05:55.513168, /home/brokenquark/repo-ansi/atulsian89@Streisand/playbooks/roles/stunnel/vars/main.yml,1,0,0,0,0,0,1
2019-03-09 02:05:55.521538, /home/brokenquark/repo-ansi/atulsian89@Streisand/playbooks/roles/stunnel/tasks/main.yml,1,0,0,0,0,0,1
2019-03-09 02:05:55.525393, /home/brokenquark/repo-ansi/atulsian89@Streisand/playbooks/roles/rc-local/tasks/main.yml,1,0,0,0,0,0,1
2019-03-09 02:05:55.538043, /home/brokenquark/repo-ansi/atulsian89@Streisand/playbooks/roles/shadowsocks/tasks/main.yml,3,0,0,0,0,0,3
2019-03-09 02:06:01.778361, /home/brokenquark/repo-ansi/benregn@cookiecutter-django-ansible/{{cookiecutter.repo_name}}/provisioning/playbooks/roles/rabbitmq/defaults/main.yml,1,0,0,0,0,0,1
2019-03-09 02:06:09.339201, /home/brokenquark/repo-ansi/bugcy013@edx_infra/playbooks/roles/jenkins_master/defaults/main.yml,1,0,1,0,0,0,2
2019-03-09 02:06:09.359468, /home/brokenquark/repo-ansi/bugcy013@edx_infra/playbooks/roles/jenkins_master/tasks/main.yml,0,0,0,0,4,0,4
2019-03-09 02:06:09.375751, /home/brokenquark/repo-ansi/bugcy013@edx_infra/playbooks/roles/common/defaults/main.yml,11,1,2,0,0,0,14
2019-03-09 02:06:09.390808, /home/brokenquark/repo-ansi/bugcy013@edx_infra/playbooks/roles/common/tasks/main.yml,0,0,0,0,1,0,1
2019-03-09 02:06:09.413697, /home/brokenquark/repo-ansi/bugcy013@edx_infra/playbooks/roles/harprofiler/defaults/main.yml,1,0,0,0,0,0,1
2019-03-09 02:06:09.481074, /home/brokenquark/repo-ansi/bugcy013@edx_infra/playbooks/roles/edx_service_rds/defaults/main.yml,2,0,0,4,0,0,6
2019-03-09 02:06:09.537115, /home/brokenquark/repo-ansi/bugcy013@edx_infra/playbooks/roles/newrelic-npi/defaults/main.yml,1,0,0,0,0,0,1
2019-03-09 02:06:09.561207, /home/brokenquark/repo-ansi/bugcy013@edx_infra/playbooks/roles/xserver/defaults/main.yml,2,0,0,0,0,0,2
2019-03-09 02:06:09.596433, /home/brokenquark/repo-ansi/bugcy013@edx_infra/playbooks/roles/test_build_server/defaults/main.yml,1,0,0,0,0,0,1
2019-03-09 02:06:09.611343, /home/brokenquark/repo-ansi/bugcy013@edx_infra/playbooks/roles/aws/defaults/main.yml,3,0,1,0,1,1,6
2019-03-09 02:06:09.627668, /home/brokenquark/repo-ansi/bugcy013@edx_infra/playbooks/roles/aws/tasks/main.yml,1,0,0,0,2,0,3
2019-03-09 02:06:09.642740, /home/brokenquark/repo-ansi/bugcy013@edx_infra/playbooks/roles/forum/defaults/main.yml,3,0,0,1,0,0,4
2019-03-09 02:06:09.715098, /home/brokenquark/repo-ansi/bugcy013@edx_infra/playbooks/roles/ora/defaults/main.yml,7,0,0,0,0,0,7
2019-03-09 02:06:09.747336, /home/brokenquark/repo-ansi/bugcy013@edx_infra/playbooks/roles/redis/defaults/main.yml,1,1,0,0,0,0,2
2019-03-09 02:06:09.758163, /home/brokenquark/repo-ansi/bugcy013@edx_infra/playbooks/roles/elasticsearch/defaults/main.yml,1,0,0,0,0,0,1
2019-03-09 02:06:09.777419, /home/brokenquark/repo-ansi/bugcy013@edx_infra/playbooks/roles/antivirus/defaults/main.yml,1,0,0,0,0,0,1
2019-03-09 02:06:09.805358, /home/brokenquark/repo-ansi/bugcy013@edx_infra/playbooks/roles/flower/defaults/main.yml,4,0,0,1,0,0,5
2019-03-09 02:06:09.819627, /home/brokenquark/repo-ansi/bugcy013@edx_infra/playbooks/roles/gh_mirror/defaults/main.yml,1,0,0,0,0,0,1
2019-03-09 02:06:09.836750, /home/brokenquark/repo-ansi/bugcy013@edx_infra/playbooks/roles/elasticsearch-monitor/tasks/main.yml,1,0,0,0,0,0,1
2019-03-09 02:06:09.842563, /home/brokenquark/repo-ansi/bugcy013@edx_infra/playbooks/roles/devpi/defaults/main.yml,2,0,0,0,0,0,2
2019-03-09 02:06:09.882401, /home/brokenquark/repo-ansi/bugcy013@edx_infra/playbooks/roles/user/defaults/main.yml,0,0,0,0,1,0,1
2019-03-09 02:06:09.938341, /home/brokenquark/repo-ansi/bugcy013@edx_infra/playbooks/roles/ecommerce/defaults/main.yml,7,0,0,0,0,0,7
2019-03-09 02:06:09.972851, /home/brokenquark/repo-ansi/bugcy013@edx_infra/playbooks/roles/newrelic/tasks/newrelic-logwatcher.yml,1,0,0,0,0,0,1
2019-03-09 02:06:09.995929, /home/brokenquark/repo-ansi/bugcy013@edx_infra/playbooks/roles/newrelic/meta/main.yml,2,0,0,0,0,0,2
2019-03-09 02:06:10.007623, /home/brokenquark/repo-ansi/bugcy013@edx_infra/playbooks/roles/alton/defaults/main.yml,6,0,0,0,0,0,6
2019-03-09 02:06:10.059013, /home/brokenquark/repo-ansi/bugcy013@edx_infra/playbooks/roles/gluster/tasks/main.yml,0,0,0,0,1,0,1
2019-03-09 02:06:10.071719, /home/brokenquark/repo-ansi/bugcy013@edx_infra/playbooks/roles/certs/defaults/main.yml,4,0,0,0,0,0,4
2019-03-09 02:06:10.107988, /home/brokenquark/repo-ansi/bugcy013@edx_infra/playbooks/roles/demo/defaults/main.yml,6,0,0,0,0,0,6
2019-03-09 02:06:10.119952, /home/brokenquark/repo-ansi/bugcy013@edx_infra/playbooks/roles/oraclejdk/defaults/main.yml,0,0,1,0,0,0,1
2019-03-09 02:06:10.132153, /home/brokenquark/repo-ansi/bugcy013@edx_infra/playbooks/roles/splunkforwarder/defaults/main.yml,0,1,0,0,0,0,1
2019-03-09 02:06:10.142413, /home/brokenquark/repo-ansi/bugcy013@edx_infra/playbooks/roles/splunkforwarder/tasks/main.yml,1,0,0,0,0,0,1
2019-03-09 02:06:10.160298, /home/brokenquark/repo-ansi/bugcy013@edx_infra/playbooks/roles/notifier/defaults/main.yml,2,2,0,0,0,0,4
2019-03-09 02:06:10.202183, /home/brokenquark/repo-ansi/bugcy013@edx_infra/playbooks/roles/edx_ansible/defaults/main.yml,1,0,0,0,0,0,1
2019-03-09 02:06:10.234276, /home/brokenquark/repo-ansi/bugcy013@edx_infra/playbooks/roles/snort/defaults/main.yml,0,0,2,0,0,1,3
2019-03-09 02:06:10.264895, /home/brokenquark/repo-ansi/bugcy013@edx_infra/playbooks/roles/mariadb/defaults/main.yml,3,0,0,0,0,0,3
2019-03-09 02:06:10.314453, /home/brokenquark/repo-ansi/bugcy013@edx_infra/playbooks/roles/minos/meta/main.yml,1,0,0,0,0,0,1
2019-03-09 02:06:10.338993, /home/brokenquark/repo-ansi/bugcy013@edx_infra/playbooks/roles/gitreload/defaults/main.yml,1,0,0,0,0,0,1
2019-03-09 02:06:10.366449, /home/brokenquark/repo-ansi/bugcy013@edx_infra/playbooks/roles/locust/defaults/main.yml,1,0,0,0,0,0,1
2019-03-09 02:06:10.383164, /home/brokenquark/repo-ansi/bugcy013@edx_infra/playbooks/roles/s3fs/defaults/main.yml,0,0,1,0,0,0,1
2019-03-09 02:06:10.398586, /home/brokenquark/repo-ansi/bugcy013@edx_infra/playbooks/roles/mongo/defaults/main.yml,7,0,1,0,0,0,8
2019-03-09 02:06:10.597305, /home/brokenquark/repo-ansi/bugcy013@edx_infra/playbooks/roles/edxapp/defaults/main.yml,16,1,2,0,1,0,20
2019-03-09 02:06:10.665796, /home/brokenquark/repo-ansi/bugcy013@edx_infra/playbooks/roles/edxapp/tasks/deploy.yml,0,0,0,0,3,0,3
2019-03-09 02:06:10.718974, /home/brokenquark/repo-ansi/bugcy013@edx_infra/playbooks/roles/edx_notes_api/defaults/main.yml,3,0,0,0,0,0,3
2019-03-09 02:06:10.762171, /home/brokenquark/repo-ansi/bugcy013@edx_infra/playbooks/roles/rabbitmq/defaults/main.yml,5,0,2,0,0,1,8
2019-03-09 02:06:10.786872, /home/brokenquark/repo-ansi/bugcy013@edx_infra/playbooks/roles/rabbitmq/tasks/main.yml,1,0,0,0,1,0,2
2019-03-09 02:06:10.814726, /home/brokenquark/repo-ansi/bugcy013@edx_infra/playbooks/roles/insights/defaults/main.yml,7,0,1,0,0,0,8
2019-03-09 02:06:10.848221, /home/brokenquark/repo-ansi/bugcy013@edx_infra/playbooks/roles/supervisor/defaults/main.yml,1,0,0,0,0,0,1
2019-03-09 02:06:10.873088, /home/brokenquark/repo-ansi/bugcy013@edx_infra/playbooks/roles/browsers/defaults/main.yml,0,0,1,0,0,1,2
2019-03-09 02:06:10.888771, /home/brokenquark/repo-ansi/bugcy013@edx_infra/playbooks/roles/nltk/defaults/main.yml,0,0,3,0,0,3,6
2019-03-09 02:06:10.911202, /home/brokenquark/repo-ansi/bugcy013@edx_infra/playbooks/roles/analytics_api/defaults/main.yml,8,0,0,0,0,0,8
2019-03-09 02:06:11.066808, /home/brokenquark/repo-ansi/bugcy013@edx_infra/playbooks/roles/jenkins_worker/defaults/main.yml,1,0,0,0,0,1,2
2019-03-09 02:06:11.092984, /home/brokenquark/repo-ansi/bugcy013@edx_infra/playbooks/roles/jenkins_worker/tasks/system.yml,0,0,0,0,2,0,2
2019-03-09 02:06:11.120498, /home/brokenquark/repo-ansi/bugcy013@edx_infra/playbooks/roles/datadog/defaults/main.yml,1,0,0,0,0,0,1
2019-03-09 02:06:11.154403, /home/brokenquark/repo-ansi/bugcy013@edx_infra/playbooks/roles/xqueue/defaults/main.yml,5,0,0,0,0,0,5
2019-03-09 02:06:11.191597, /home/brokenquark/repo-ansi/bugcy013@edx_infra/playbooks/roles/nginx/defaults/main.yml,2,0,0,0,0,0,2
2019-03-09 02:06:11.218076, /home/brokenquark/repo-ansi/bugcy013@edx_infra/playbooks/roles/shibboleth/defaults/main.yml,3,0,1,0,0,0,4
2019-03-09 02:06:11.227826, /home/brokenquark/repo-ansi/bugcy013@edx_infra/playbooks/roles/jscover/defaults/main.yml,0,0,1,0,0,0,1
2019-03-09 02:06:11.256395, /home/brokenquark/repo-ansi/bugcy013@edx_infra/playbooks/roles/local_dev/defaults/main.yml,1,0,0,0,0,0,1
2019-03-09 02:06:11.270992, /home/brokenquark/repo-ansi/bugcy013@edx_infra/playbooks/roles/cassandra/defaults/main.yml,1,0,0,0,0,0,1
2019-03-09 02:06:11.282496, /home/brokenquark/repo-ansi/bugcy013@edx_infra/playbooks/roles/cassandra/tasks/main.yml,0,0,1,0,0,0,1
2019-03-09 02:06:11.306853, /home/brokenquark/repo-ansi/bugcy013@edx_infra/playbooks/edx-west/stage-worker.yml,1,0,0,0,0,0,1
2019-03-09 02:06:11.383350, /home/brokenquark/repo-ansi/bugcy013@edx_infra/playbooks/edx-west/stage-notifier-only.yml,1,0,0,0,0,0,1
2019-03-09 02:06:11.557456, /home/brokenquark/repo-ansi/bugcy013@edx_infra/playbooks/edx-east/edx_provision.yml,3,0,0,0,0,0,3
2019-03-09 02:06:11.566482, /home/brokenquark/repo-ansi/bugcy013@edx_infra/playbooks/edx-east/add-ubuntu-key.yml,1,0,0,0,0,0,1
2019-03-09 02:06:11.607047, /home/brokenquark/repo-ansi/bugcy013@edx_infra/playbooks/edx-east/remove-ubuntu-key.yml,1,0,0,0,0,0,1
2019-03-09 02:06:11.631624, /home/brokenquark/repo-ansi/bugcy013@edx_infra/playbooks/edx-east/edx_notifier.yml,5,0,0,0,0,0,5
2019-03-09 02:06:11.716756, /home/brokenquark/repo-ansi/bugcy013@edx_infra/playbooks/edx-east/ora2.yml,3,0,0,0,0,0,3
2019-03-09 02:06:11.952713, /home/brokenquark/repo-ansi/carlosthe19916@openshift-ansible/playbooks/common/openshift-master/config.yml,1,0,0,0,0,0,1
2019-03-09 02:06:12.023982, /home/brokenquark/repo-ansi/carlosthe19916@openshift-ansible/playbooks/aws/ansible-tower/config.yml,1,0,0,0,0,0,1
2019-03-09 02:06:12.026397, /home/brokenquark/repo-ansi/carlosthe19916@openshift-ansible/playbooks/aws/ansible-tower/vars.ops.yml,1,0,0,0,0,0,1
2019-03-09 02:06:12.037331, /home/brokenquark/repo-ansi/carlosthe19916@openshift-ansible/playbooks/aws/ansible-tower/launch.yml,1,0,0,0,0,0,1
2019-03-09 02:06:12.055023, /home/brokenquark/repo-ansi/carlosthe19916@openshift-ansible/playbooks/aws/openshift-cluster/vars.yml,3,0,0,0,0,0,3
2019-03-09 02:06:12.141527, /home/brokenquark/repo-ansi/carlosthe19916@openshift-ansible/playbooks/adhoc/zabbix_setup/setup_zabbix.yml,2,0,1,0,0,0,3
2019-03-09 02:06:12.151902, /home/brokenquark/repo-ansi/carlosthe19916@openshift-ansible/playbooks/adhoc/zabbix_setup/clean_zabbix.yml,2,0,1,0,0,0,3
2019-03-09 02:06:12.157474, /home/brokenquark/repo-ansi/carlosthe19916@openshift-ansible/playbooks/adhoc/zabbix_setup/create_app.yml,2,0,1,0,0,0,3
2019-03-09 02:06:12.164200, /home/brokenquark/repo-ansi/carlosthe19916@openshift-ansible/playbooks/adhoc/zabbix_setup/create_template.yml,0,0,0,0,3,0,3
2019-03-09 02:06:12.167153, /home/brokenquark/repo-ansi/carlosthe19916@openshift-ansible/playbooks/adhoc/zabbix_setup/create_application.yml,1,0,0,0,0,0,1
2019-03-09 02:06:12.172987, /home/brokenquark/repo-ansi/carlosthe19916@openshift-ansible/playbooks/adhoc/zabbix_setup/vars/template_heartbeat.yml,3,0,0,0,0,0,3
2019-03-09 02:06:12.178237, /home/brokenquark/repo-ansi/carlosthe19916@openshift-ansible/playbooks/adhoc/zabbix_setup/vars/template_node.yml,3,0,0,0,0,0,3
2019-03-09 02:06:12.183590, /home/brokenquark/repo-ansi/carlosthe19916@openshift-ansible/playbooks/adhoc/zabbix_setup/vars/template_router.yml,3,0,0,0,0,0,3
2019-03-09 02:06:12.188699, /home/brokenquark/repo-ansi/carlosthe19916@openshift-ansible/playbooks/adhoc/zabbix_setup/vars/template_master.yml,3,0,0,0,0,0,3
2019-03-09 02:06:12.232198, /home/brokenquark/repo-ansi/carlosthe19916@openshift-ansible/playbooks/adhoc/zabbix_setup/vars/template_os_linux.yml,59,0,0,0,0,0,59
2019-03-09 02:06:12.238063, /home/brokenquark/repo-ansi/carlosthe19916@openshift-ansible/playbooks/adhoc/zabbix_setup/vars/template_host.yml,3,0,0,0,0,0,3
2019-03-09 02:06:12.247795, /home/brokenquark/repo-ansi/carlosthe19916@openshift-ansible/playbooks/adhoc/noc/create_host.yml,1,0,0,0,0,0,1
2019-03-09 02:06:12.279261, /home/brokenquark/repo-ansi/carlosthe19916@openshift-ansible/playbooks/openstack/openshift-cluster/vars.yml,3,0,0,0,0,0,3
2019-03-09 02:06:12.390509, /home/brokenquark/repo-ansi/carlosthe19916@openshift-ansible/playbooks/openstack/openshift-cluster/files/heat_stack.yaml,0,0,0,1,0,0,1
2019-03-09 02:06:12.414237, /home/brokenquark/repo-ansi/carlosthe19916@openshift-ansible/playbooks/libvirt/openshift-cluster/vars.yml,3,0,0,0,0,0,3
2019-03-09 02:06:12.498196, /home/brokenquark/repo-ansi/carlosthe19916@openshift-ansible/playbooks/gce/openshift-cluster/wip.yml,1,0,0,0,0,0,1
2019-03-09 02:06:12.502296, /home/brokenquark/repo-ansi/carlosthe19916@openshift-ansible/playbooks/gce/openshift-cluster/config.yml,0,0,0,0,1,0,1
2019-03-09 02:06:12.504693, /home/brokenquark/repo-ansi/carlosthe19916@openshift-ansible/playbooks/gce/openshift-cluster/vars.yml,1,0,0,0,0,0,1
2019-03-09 02:06:18.069784, /home/brokenquark/repo-ansi/ceph@ceph-ansible/infrastructure-playbooks/switch-from-non-containerized-to-containerized-ceph-daemons.yml,16,0,0,0,0,0,16
2019-03-09 02:06:18.191135, /home/brokenquark/repo-ansi/ceph@ceph-ansible/infrastructure-playbooks/rgw-add-users-buckets.yml,17,0,0,0,0,0,17
2019-03-09 02:06:18.513217, /home/brokenquark/repo-ansi/ceph@ceph-ansible/infrastructure-playbooks/untested-by-ci/make-osd-partitions.yml,2,0,0,0,0,0,2
2019-03-09 02:06:19.141389, /home/brokenquark/repo-ansi/chenshuchuan@configuration/playbooks/roles/jenkins_master/defaults/main.yml,1,0,1,0,0,0,2
2019-03-09 02:06:19.156156, /home/brokenquark/repo-ansi/chenshuchuan@configuration/playbooks/roles/jenkins_master/tasks/main.yml,1,0,0,0,4,0,5
2019-03-09 02:06:19.169177, /home/brokenquark/repo-ansi/chenshuchuan@configuration/playbooks/roles/common/defaults/main.yml,8,0,1,0,0,0,9
2019-03-09 02:06:19.180016, /home/brokenquark/repo-ansi/chenshuchuan@configuration/playbooks/roles/common/tasks/main.yml,0,0,0,0,1,0,1
2019-03-09 02:06:19.194099, /home/brokenquark/repo-ansi/chenshuchuan@configuration/playbooks/roles/gerrit/defaults/main.yml,1,0,0,0,0,0,1
2019-03-09 02:06:19.222363, /home/brokenquark/repo-ansi/chenshuchuan@configuration/playbooks/roles/xserver/defaults/main.yml,3,0,0,0,0,0,3
2019-03-09 02:06:19.250622, /home/brokenquark/repo-ansi/chenshuchuan@configuration/playbooks/roles/aws/defaults/main.yml,0,0,1,0,1,1,3
2019-03-09 02:06:19.269709, /home/brokenquark/repo-ansi/chenshuchuan@configuration/playbooks/roles/forum/defaults/main.yml,3,0,0,1,0,0,4
2019-03-09 02:06:19.320803, /home/brokenquark/repo-ansi/chenshuchuan@configuration/playbooks/roles/ora/defaults/main.yml,15,0,0,0,0,0,15
2019-03-09 02:06:19.356109, /home/brokenquark/repo-ansi/chenshuchuan@configuration/playbooks/roles/elasticsearch/defaults/main.yml,1,0,0,0,0,0,1
2019-03-09 02:06:19.367361, /home/brokenquark/repo-ansi/chenshuchuan@configuration/playbooks/roles/gh_mirror/defaults/main.yml,1,0,0,0,0,0,1
2019-03-09 02:06:19.385888, /home/brokenquark/repo-ansi/chenshuchuan@configuration/playbooks/roles/analytics/defaults/main.yml,8,0,0,0,0,0,8
2019-03-09 02:06:19.410760, /home/brokenquark/repo-ansi/chenshuchuan@configuration/playbooks/roles/devpi/defaults/main.yml,2,0,0,0,0,0,2
2019-03-09 02:06:19.455736, /home/brokenquark/repo-ansi/chenshuchuan@configuration/playbooks/roles/user/defaults/main.yml,0,0,0,0,1,0,1
2019-03-09 02:06:19.504015, /home/brokenquark/repo-ansi/chenshuchuan@configuration/playbooks/roles/gluster/tasks/main.yml,0,0,0,0,1,0,1
2019-03-09 02:06:19.512038, /home/brokenquark/repo-ansi/chenshuchuan@configuration/playbooks/roles/certs/defaults/main.yml,9,0,0,0,0,0,9
2019-03-09 02:06:19.536941, /home/brokenquark/repo-ansi/chenshuchuan@configuration/playbooks/roles/demo/defaults/main.yml,5,0,0,0,0,0,5
2019-03-09 02:06:19.559240, /home/brokenquark/repo-ansi/chenshuchuan@configuration/playbooks/roles/splunkforwarder/defaults/main.yml,0,1,0,0,0,0,1
2019-03-09 02:06:19.570204, /home/brokenquark/repo-ansi/chenshuchuan@configuration/playbooks/roles/splunkforwarder/tasks/main.yml,1,0,0,0,0,0,1
2019-03-09 02:06:19.587671, /home/brokenquark/repo-ansi/chenshuchuan@configuration/playbooks/roles/notifier/defaults/main.yml,6,2,0,0,0,0,8
2019-03-09 02:06:19.612519, /home/brokenquark/repo-ansi/chenshuchuan@configuration/playbooks/roles/edx_ansible/defaults/main.yml,1,0,0,0,0,0,1
2019-03-09 02:06:19.671984, /home/brokenquark/repo-ansi/chenshuchuan@configuration/playbooks/roles/s3fs/defaults/main.yml,0,0,1,0,0,0,1
2019-03-09 02:06:19.687574, /home/brokenquark/repo-ansi/chenshuchuan@configuration/playbooks/roles/mongo/defaults/main.yml,5,0,0,1,0,0,6
2019-03-09 02:06:19.696218, /home/brokenquark/repo-ansi/chenshuchuan@configuration/playbooks/roles/mongo/tasks/main.yml,1,0,0,0,0,0,1
2019-03-09 02:06:19.778407, /home/brokenquark/repo-ansi/chenshuchuan@configuration/playbooks/roles/edxapp/defaults/main.yml,100,0,1,0,0,0,101
2019-03-09 02:06:19.827295, /home/brokenquark/repo-ansi/chenshuchuan@configuration/playbooks/roles/edxapp/tasks/deploy.yml,0,0,0,0,2,0,2
2019-03-09 02:06:19.891282, /home/brokenquark/repo-ansi/chenshuchuan@configuration/playbooks/roles/rabbitmq/defaults/main.yml,4,0,1,0,0,0,5
2019-03-09 02:06:19.910030, /home/brokenquark/repo-ansi/chenshuchuan@configuration/playbooks/roles/rabbitmq/tasks/main.yml,1,0,0,0,1,0,2
2019-03-09 02:06:19.921176, /home/brokenquark/repo-ansi/chenshuchuan@configuration/playbooks/roles/analytics-server/defaults/main.yml,8,0,0,0,0,0,8
2019-03-09 02:06:19.950571, /home/brokenquark/repo-ansi/chenshuchuan@configuration/playbooks/roles/supervisor/defaults/main.yml,1,0,0,0,0,0,1
2019-03-09 02:06:19.971661, /home/brokenquark/repo-ansi/chenshuchuan@configuration/playbooks/roles/browsers/defaults/main.yml,0,0,1,0,0,1,2
2019-03-09 02:06:19.994594, /home/brokenquark/repo-ansi/chenshuchuan@configuration/playbooks/roles/discern/defaults/main.yml,5,0,0,0,0,0,5
2019-03-09 02:06:20.018359, /home/brokenquark/repo-ansi/chenshuchuan@configuration/playbooks/roles/discern/tasks/main.yml,0,0,0,0,1,0,1
2019-03-09 02:06:20.100196, /home/brokenquark/repo-ansi/chenshuchuan@configuration/playbooks/roles/jenkins_worker/defaults/main.yml,1,0,1,0,0,1,3
2019-03-09 02:06:20.106571, /home/brokenquark/repo-ansi/chenshuchuan@configuration/playbooks/roles/jenkins_worker/tasks/system.yml,0,0,0,0,1,0,1
2019-03-09 02:06:20.121035, /home/brokenquark/repo-ansi/chenshuchuan@configuration/playbooks/roles/datadog/defaults/main.yml,2,0,1,0,0,0,3
2019-03-09 02:06:20.144621, /home/brokenquark/repo-ansi/chenshuchuan@configuration/playbooks/roles/xqueue/defaults/main.yml,11,0,0,0,0,0,11
2019-03-09 02:06:20.175533, /home/brokenquark/repo-ansi/chenshuchuan@configuration/playbooks/roles/nginx/defaults/main.yml,2,2,0,0,0,0,4
2019-03-09 02:06:20.195226, /home/brokenquark/repo-ansi/chenshuchuan@configuration/playbooks/roles/shibboleth/defaults/main.yml,3,0,1,0,0,0,4
2019-03-09 02:06:20.215514, /home/brokenquark/repo-ansi/chenshuchuan@configuration/playbooks/roles/local_dev/defaults/main.yml,1,0,0,0,0,0,1
2019-03-09 02:06:20.239901, /home/brokenquark/repo-ansi/chenshuchuan@configuration/playbooks/edx-west/stage-worker.yml,1,0,0,0,0,0,1
2019-03-09 02:06:20.309523, /home/brokenquark/repo-ansi/chenshuchuan@configuration/playbooks/edx-west/stage-notifier-only.yml,1,0,0,0,0,0,1
2019-03-09 02:06:20.387276, /home/brokenquark/repo-ansi/chenshuchuan@configuration/playbooks/edx-east/edx_provision.yml,2,0,0,0,0,0,2
2019-03-09 02:06:20.438133, /home/brokenquark/repo-ansi/chenshuchuan@configuration/playbooks/edx-east/edx_notifier.yml,5,0,0,0,0,0,5
2019-03-09 02:06:20.479742, /home/brokenquark/repo-ansi/chenshuchuan@configuration/playbooks/edx-east/create_dbs.yml,4,0,0,0,0,0,4
2019-03-09 02:06:20.484948, /home/brokenquark/repo-ansi/chenshuchuan@configuration/playbooks/secure_example/vars/edxapp_ref_custom_vars.yml,2,0,0,0,0,0,2
2019-03-09 02:06:20.520612, /home/brokenquark/repo-ansi/chenshuchuan@configuration/playbooks/secure_example/vars/edxapp_ref_vars.yml,34,0,0,0,0,0,34
2019-03-09 02:06:20.523463, /home/brokenquark/repo-ansi/chenshuchuan@configuration/playbooks/secure_example/vars/edxapp_ref_users.yml,2,0,0,0,0,0,2
2019-03-09 02:06:20.526729, /home/brokenquark/repo-ansi/chenshuchuan@configuration/playbooks/secure_example/vars/gerrit.yml,7,0,0,0,0,0,7
2019-03-09 02:06:35.709140, /home/brokenquark/repo-ansi/cloudmesh@sp17-i524/project/S17-IO-3012/code/playbooks/mongo-install32.yaml,1,0,0,0,0,0,1
2019-03-09 02:06:35.732620, /home/brokenquark/repo-ansi/cloudmesh@sp17-i524/project/S17-IO-3012/code/playbooks/fix-sudo.yaml,1,0,0,0,0,0,1
2019-03-09 02:06:35.747988, /home/brokenquark/repo-ansi/cloudmesh@sp17-i524/project/S17-IO-3012/code/playbooks/mongo-install34.yaml,1,0,0,0,0,0,1
2019-03-09 02:06:35.762123, /home/brokenquark/repo-ansi/cloudmesh@sp17-i524/project/S17-IR-2013/code/playbooks/move_data.yml,5,0,0,0,0,0,5
2019-03-09 02:06:35.768824, /home/brokenquark/repo-ansi/cloudmesh@sp17-i524/project/S17-IR-2013/code/playbooks/move_data_hdfs.yml,1,0,0,0,0,0,1
2019-03-09 02:06:56.528280, /home/brokenquark/repo-ansi/d34dh0r53@os-ansible-deployment/playbooks/memcached-install.yml,1,0,0,0,0,0,1
2019-03-09 02:06:56.533194, /home/brokenquark/repo-ansi/d34dh0r53@os-ansible-deployment/playbooks/repo-clone-mirror.yml,1,0,0,0,0,0,1
2019-03-09 02:06:56.535730, /home/brokenquark/repo-ansi/d34dh0r53@os-ansible-deployment/playbooks/openstack-hosts-setup.yml,1,0,0,0,0,0,1
2019-03-09 02:06:56.539418, /home/brokenquark/repo-ansi/d34dh0r53@os-ansible-deployment/playbooks/repo-store-source.yml,1,0,0,0,0,0,1
2019-03-09 02:06:56.545727, /home/brokenquark/repo-ansi/d34dh0r53@os-ansible-deployment/playbooks/rabbitmq-install.yml,1,0,0,0,0,0,1
2019-03-09 02:06:56.564106, /home/brokenquark/repo-ansi/d34dh0r53@os-ansible-deployment/playbooks/os-keystone-install.yml,1,0,0,0,0,0,1
2019-03-09 02:06:56.579403, /home/brokenquark/repo-ansi/d34dh0r53@os-ansible-deployment/playbooks/os-glance-install.yml,1,0,0,0,0,0,1
2019-03-09 02:06:56.596801, /home/brokenquark/repo-ansi/d34dh0r53@os-ansible-deployment/playbooks/os-nova-install.yml,1,0,0,0,0,0,1
2019-03-09 02:06:56.601026, /home/brokenquark/repo-ansi/d34dh0r53@os-ansible-deployment/playbooks/os-tempest-install.yml,1,0,0,0,0,0,1
2019-03-09 02:06:56.611348, /home/brokenquark/repo-ansi/d34dh0r53@os-ansible-deployment/playbooks/os-swift-install.yml,2,0,0,0,0,0,2
2019-03-09 02:06:56.619995, /home/brokenquark/repo-ansi/d34dh0r53@os-ansible-deployment/playbooks/repo-build.yml,1,0,0,0,0,0,1
2019-03-09 02:06:56.633195, /home/brokenquark/repo-ansi/d34dh0r53@os-ansible-deployment/playbooks/os-horizon-install.yml,1,0,0,0,0,0,1
2019-03-09 02:06:56.641843, /home/brokenquark/repo-ansi/d34dh0r53@os-ansible-deployment/playbooks/galera-install.yml,1,0,0,0,0,0,1
2019-03-09 02:06:56.660557, /home/brokenquark/repo-ansi/d34dh0r53@os-ansible-deployment/playbooks/os-cinder-install.yml,1,0,0,0,0,0,1
2019-03-09 02:06:56.672384, /home/brokenquark/repo-ansi/d34dh0r53@os-ansible-deployment/playbooks/utility-install.yml,3,0,0,0,0,0,3
2019-03-09 02:06:56.683175, /home/brokenquark/repo-ansi/d34dh0r53@os-ansible-deployment/playbooks/rsyslog-install.yml,1,0,0,0,0,0,1
2019-03-09 02:06:56.703347, /home/brokenquark/repo-ansi/d34dh0r53@os-ansible-deployment/playbooks/os-neutron-install.yml,1,0,0,0,0,0,1
2019-03-09 02:06:56.713745, /home/brokenquark/repo-ansi/d34dh0r53@os-ansible-deployment/playbooks/os-heat-install.yml,1,0,0,0,0,0,1
2019-03-09 02:06:56.720923, /home/brokenquark/repo-ansi/d34dh0r53@os-ansible-deployment/playbooks/lxc-containers-destroy.yml,2,0,0,0,0,0,2
2019-03-09 02:06:56.724289, /home/brokenquark/repo-ansi/d34dh0r53@os-ansible-deployment/playbooks/haproxy-install.yml,1,0,0,0,0,0,1
2019-03-09 02:06:56.729579, /home/brokenquark/repo-ansi/d34dh0r53@os-ansible-deployment/playbooks/lxc-containers-create.yml,1,0,0,0,0,0,1
2019-03-09 02:06:56.734046, /home/brokenquark/repo-ansi/d34dh0r53@os-ansible-deployment/playbooks/lxc-hosts-setup.yml,1,0,0,0,0,0,1
2019-03-09 02:06:56.742869, /home/brokenquark/repo-ansi/d34dh0r53@os-ansible-deployment/playbooks/repo-server.yml,1,0,0,0,0,0,1
2019-03-09 02:06:56.805558, /home/brokenquark/repo-ansi/d34dh0r53@os-ansible-deployment/playbooks/roles/lxc_hosts/defaults/main.yml,3,0,0,0,0,0,3
2019-03-09 02:06:56.819760, /home/brokenquark/repo-ansi/d34dh0r53@os-ansible-deployment/playbooks/roles/lxc_hosts/tasks/lxc_pre_install.yml,1,0,0,0,0,0,1
2019-03-09 02:06:56.868726, /home/brokenquark/repo-ansi/d34dh0r53@os-ansible-deployment/playbooks/roles/os_swift/defaults/main.yml,6,0,0,0,0,0,6
2019-03-09 02:06:56.899805, /home/brokenquark/repo-ansi/d34dh0r53@os-ansible-deployment/playbooks/roles/os_swift/tasks/swift_pre_install.yml,3,0,0,0,0,0,3
2019-03-09 02:06:56.956807, /home/brokenquark/repo-ansi/d34dh0r53@os-ansible-deployment/playbooks/roles/os_swift/tasks/swift_upstart_common_init.yml,1,0,0,0,0,0,1
2019-03-09 02:06:56.960654, /home/brokenquark/repo-ansi/d34dh0r53@os-ansible-deployment/playbooks/roles/os_swift/tasks/swift_rings_distribute.yml,0,0,0,0,1,0,1
2019-03-09 02:06:56.975718, /home/brokenquark/repo-ansi/d34dh0r53@os-ansible-deployment/playbooks/roles/os_swift/tasks/swift_key_create.yml,2,0,0,0,0,0,2
2019-03-09 02:06:56.993976, /home/brokenquark/repo-ansi/d34dh0r53@os-ansible-deployment/playbooks/roles/os_swift/tasks/swift_storage_hosts_setup.yml,2,0,0,0,0,0,2
2019-03-09 02:06:57.104132, /home/brokenquark/repo-ansi/d34dh0r53@os-ansible-deployment/playbooks/roles/memcached_server/defaults/main.yml,1,0,0,0,0,0,1
2019-03-09 02:06:57.110031, /home/brokenquark/repo-ansi/d34dh0r53@os-ansible-deployment/playbooks/roles/memcached_server/tasks/memcached_config.yml,1,0,0,0,0,0,1
2019-03-09 02:06:57.144953, /home/brokenquark/repo-ansi/d34dh0r53@os-ansible-deployment/playbooks/roles/os_glance/defaults/main.yml,5,0,0,2,0,0,7
2019-03-09 02:06:57.150316, /home/brokenquark/repo-ansi/d34dh0r53@os-ansible-deployment/playbooks/roles/os_glance/tasks/glance_upstart_common_init.yml,1,0,0,0,0,0,1
2019-03-09 02:06:57.176255, /home/brokenquark/repo-ansi/d34dh0r53@os-ansible-deployment/playbooks/roles/os_glance/tasks/glance_pre_install.yml,1,0,0,0,0,0,1
2019-03-09 02:06:57.211884, /home/brokenquark/repo-ansi/d34dh0r53@os-ansible-deployment/playbooks/roles/os_glance/tasks/glance_post_install.yml,1,0,0,0,0,0,1
2019-03-09 02:06:57.248227, /home/brokenquark/repo-ansi/d34dh0r53@os-ansible-deployment/playbooks/roles/galera_client/defaults/main.yml,2,0,0,0,0,0,2
2019-03-09 02:06:57.261274, /home/brokenquark/repo-ansi/d34dh0r53@os-ansible-deployment/playbooks/roles/galera_client/tasks/galera_client_pre_install.yml,1,0,0,0,0,0,1
2019-03-09 02:06:57.266081, /home/brokenquark/repo-ansi/d34dh0r53@os-ansible-deployment/playbooks/roles/galera_client/tasks/galera_client_post_install.yml,1,0,0,0,0,0,1
2019-03-09 02:06:57.279061, /home/brokenquark/repo-ansi/d34dh0r53@os-ansible-deployment/playbooks/roles/openstack_hosts/defaults/main.yml,8,0,0,0,0,0,8
2019-03-09 02:06:57.292915, /home/brokenquark/repo-ansi/d34dh0r53@os-ansible-deployment/playbooks/roles/openstack_hosts/tasks/openstack_lvm_config.yml,1,0,0,0,0,0,1
2019-03-09 02:06:57.327490, /home/brokenquark/repo-ansi/d34dh0r53@os-ansible-deployment/playbooks/roles/openstack_hosts/tasks/openstack_release.yml,1,0,0,0,0,0,1
2019-03-09 02:06:57.366068, /home/brokenquark/repo-ansi/d34dh0r53@os-ansible-deployment/playbooks/roles/os_nova/defaults/main.yml,5,0,0,0,0,0,5
2019-03-09 02:06:57.385877, /home/brokenquark/repo-ansi/d34dh0r53@os-ansible-deployment/playbooks/roles/os_nova/tasks/nova_pre_install.yml,2,0,0,0,0,0,2
2019-03-09 02:06:57.437802, /home/brokenquark/repo-ansi/d34dh0r53@os-ansible-deployment/playbooks/roles/os_nova/tasks/nova_compute_key_create.yml,2,0,0,0,0,0,2
2019-03-09 02:06:57.491802, /home/brokenquark/repo-ansi/d34dh0r53@os-ansible-deployment/playbooks/roles/os_nova/tasks/nova_upstart_common_init.yml,1,0,0,0,0,0,1
2019-03-09 02:06:57.508492, /home/brokenquark/repo-ansi/d34dh0r53@os-ansible-deployment/playbooks/roles/os_horizon/defaults/main.yml,5,0,1,0,0,0,6
2019-03-09 02:06:57.539298, /home/brokenquark/repo-ansi/d34dh0r53@os-ansible-deployment/playbooks/roles/os_horizon/tasks/horizon_apache.yml,1,0,0,0,0,0,1
2019-03-09 02:06:57.576075, /home/brokenquark/repo-ansi/d34dh0r53@os-ansible-deployment/playbooks/roles/os_horizon/tasks/horizon_ssl_user_provided.yml,1,0,0,0,0,0,1
2019-03-09 02:06:57.586833, /home/brokenquark/repo-ansi/d34dh0r53@os-ansible-deployment/playbooks/roles/rabbitmq_server/defaults/main.yml,2,0,0,0,0,1,3
2019-03-09 02:06:57.600412, /home/brokenquark/repo-ansi/d34dh0r53@os-ansible-deployment/playbooks/roles/rabbitmq_server/tasks/rabbitmq_set_cookie.yml,1,0,0,0,0,0,1
2019-03-09 02:06:57.633286, /home/brokenquark/repo-ansi/d34dh0r53@os-ansible-deployment/playbooks/roles/openstack_openrc/defaults/main.yml,1,0,0,0,0,0,1
2019-03-09 02:06:57.656640, /home/brokenquark/repo-ansi/d34dh0r53@os-ansible-deployment/playbooks/roles/os_keystone/defaults/main.yml,6,0,0,1,0,0,7
2019-03-09 02:06:57.668429, /home/brokenquark/repo-ansi/d34dh0r53@os-ansible-deployment/playbooks/roles/os_keystone/tasks/keystone_pre_install.yml,2,0,0,0,0,0,2
2019-03-09 02:06:57.691597, /home/brokenquark/repo-ansi/d34dh0r53@os-ansible-deployment/playbooks/roles/os_keystone/tasks/keystone_apache.yml,1,0,0,0,0,0,1
2019-03-09 02:06:57.741892, /home/brokenquark/repo-ansi/d34dh0r53@os-ansible-deployment/playbooks/roles/lxc_container_create/defaults/main.yml,1,0,0,0,0,0,1
2019-03-09 02:06:57.769551, /home/brokenquark/repo-ansi/d34dh0r53@os-ansible-deployment/playbooks/roles/lxc_container_create/tasks/container_create.yml,1,0,0,0,0,0,1
2019-03-09 02:06:57.782574, /home/brokenquark/repo-ansi/d34dh0r53@os-ansible-deployment/playbooks/roles/haproxy_server/defaults/main.yml,1,0,0,0,0,0,1
2019-03-09 02:06:57.818273, /home/brokenquark/repo-ansi/d34dh0r53@os-ansible-deployment/playbooks/roles/os_heat/defaults/main.yml,10,0,0,0,0,0,10
2019-03-09 02:06:57.823465, /home/brokenquark/repo-ansi/d34dh0r53@os-ansible-deployment/playbooks/roles/os_heat/tasks/heat_upstart_common_init.yml,1,0,0,0,0,0,1
2019-03-09 02:06:57.874717, /home/brokenquark/repo-ansi/d34dh0r53@os-ansible-deployment/playbooks/roles/os_heat/tasks/heat_pre_install.yml,1,0,0,0,0,0,1
2019-03-09 02:06:57.937442, /home/brokenquark/repo-ansi/d34dh0r53@os-ansible-deployment/playbooks/roles/os_heat/files/templates/AWS_RDS_DBInstance.yaml,1,3,0,3,0,0,7
2019-03-09 02:06:57.968924, /home/brokenquark/repo-ansi/d34dh0r53@os-ansible-deployment/playbooks/roles/galera_server/defaults/main.yml,3,1,0,0,1,0,5
2019-03-09 02:06:57.978900, /home/brokenquark/repo-ansi/d34dh0r53@os-ansible-deployment/playbooks/roles/galera_server/tasks/galera_post_install.yml,2,0,0,0,0,0,2
2019-03-09 02:06:58.020218, /home/brokenquark/repo-ansi/d34dh0r53@os-ansible-deployment/playbooks/roles/galera_server/tasks/galera_pre_install.yml,1,0,0,0,0,0,1
2019-03-09 02:06:58.050689, /home/brokenquark/repo-ansi/d34dh0r53@os-ansible-deployment/playbooks/roles/os_neutron/defaults/main.yml,6,0,0,0,0,0,6
2019-03-09 02:06:58.091923, /home/brokenquark/repo-ansi/d34dh0r53@os-ansible-deployment/playbooks/roles/os_neutron/tasks/neutron_upstart_common_init.yml,1,0,0,0,0,0,1
2019-03-09 02:06:58.112679, /home/brokenquark/repo-ansi/d34dh0r53@os-ansible-deployment/playbooks/roles/os_neutron/tasks/neutron_post_install.yml,1,0,0,0,0,0,1
2019-03-09 02:06:58.131011, /home/brokenquark/repo-ansi/d34dh0r53@os-ansible-deployment/playbooks/roles/os_neutron/tasks/neutron_l3_ha.yml,3,0,0,0,0,0,3
2019-03-09 02:06:58.149120, /home/brokenquark/repo-ansi/d34dh0r53@os-ansible-deployment/playbooks/roles/os_neutron/tasks/neutron_pre_install.yml,2,0,0,0,0,0,2
2019-03-09 02:06:58.170392, /home/brokenquark/repo-ansi/d34dh0r53@os-ansible-deployment/playbooks/roles/rsyslog_server/tasks/rsyslog_server_post_install.yml,2,0,0,0,0,0,2
2019-03-09 02:06:58.173281, /home/brokenquark/repo-ansi/d34dh0r53@os-ansible-deployment/playbooks/roles/rsyslog_server/tasks/rsyslog_server_pre_install.yml,1,0,0,0,0,0,1
2019-03-09 02:06:58.190064, /home/brokenquark/repo-ansi/d34dh0r53@os-ansible-deployment/playbooks/roles/os_tempest/defaults/main.yml,4,0,2,0,0,1,7
2019-03-09 02:06:58.221044, /home/brokenquark/repo-ansi/d34dh0r53@os-ansible-deployment/playbooks/roles/os_tempest/tasks/tempest_resources.yml,0,0,1,0,0,0,1
2019-03-09 02:06:58.237015, /home/brokenquark/repo-ansi/d34dh0r53@os-ansible-deployment/playbooks/roles/os_tempest/tasks/tempest_post_install.yml,2,0,0,0,0,0,2
2019-03-09 02:06:58.256101, /home/brokenquark/repo-ansi/d34dh0r53@os-ansible-deployment/playbooks/roles/repo_server/defaults/main.yml,1,0,0,0,0,0,1
2019-03-09 02:06:58.278635, /home/brokenquark/repo-ansi/d34dh0r53@os-ansible-deployment/playbooks/roles/repo_server/tasks/repo_pre_install.yml,1,0,0,0,0,0,1
2019-03-09 02:06:58.293482, /home/brokenquark/repo-ansi/d34dh0r53@os-ansible-deployment/playbooks/roles/repo_server/tasks/repo_key_create.yml,3,0,0,0,0,0,3
2019-03-09 02:06:58.361103, /home/brokenquark/repo-ansi/d34dh0r53@os-ansible-deployment/playbooks/roles/os_cinder/defaults/main.yml,6,0,0,0,0,0,6
2019-03-09 02:06:58.373188, /home/brokenquark/repo-ansi/d34dh0r53@os-ansible-deployment/playbooks/roles/os_cinder/tasks/cinder_pre_install.yml,2,0,0,0,0,0,2
2019-03-09 02:06:58.378043, /home/brokenquark/repo-ansi/d34dh0r53@os-ansible-deployment/playbooks/roles/os_cinder/tasks/cinder_lvm_config.yml,1,0,0,0,0,0,1
2019-03-09 02:06:58.389533, /home/brokenquark/repo-ansi/d34dh0r53@os-ansible-deployment/playbooks/roles/os_cinder/tasks/cinder_upstart_common_init.yml,1,0,0,0,0,0,1
2019-03-09 02:06:58.451610, /home/brokenquark/repo-ansi/d34dh0r53@os-ansible-deployment/playbooks/roles/rsyslog_client/tasks/rsyslog_client_pre_install.yml,1,0,0,0,0,0,1
2019-03-09 02:06:58.459900, /home/brokenquark/repo-ansi/d34dh0r53@os-ansible-deployment/playbooks/roles/rsyslog_client/tasks/rsyslog_client_post_install.yml,2,0,0,0,0,0,2
2019-03-09 02:06:59.137479, /home/brokenquark/repo-ansi/debops@ansible-gitlab/docs/playbooks/gitlab.yml,0,1,0,0,0,0,1
2019-03-09 02:07:00.808727, /home/brokenquark/repo-ansi/debops@debops/ansible/playbooks/service/netbox.yml,0,1,0,0,0,0,1
2019-03-09 02:07:00.832442, /home/brokenquark/repo-ansi/debops@debops/ansible/playbooks/service/docker_registry.yml,0,1,0,0,0,0,1
2019-03-09 02:07:00.870048, /home/brokenquark/repo-ansi/debops@debops/ansible/playbooks/service/gitlab.yml,0,1,0,0,0,0,1
2019-03-09 02:07:00.981304, /home/brokenquark/repo-ansi/debops@debops/ansible/playbooks/service/etherpad.yml,0,1,0,0,0,0,1
2019-03-09 02:07:01.268996, /home/brokenquark/repo-ansi/debops@debops/ansible/playbooks/srv/docker_registry.yml,0,1,0,0,0,0,1
2019-03-09 02:07:01.431272, /home/brokenquark/repo-ansi/debops@debops/ansible/playbooks/app/netbox.yml,0,1,0,0,0,0,1
2019-03-09 02:07:01.440813, /home/brokenquark/repo-ansi/debops@debops/ansible/playbooks/app/docker_registry.yml,0,1,0,0,0,0,1
2019-03-09 02:07:01.455096, /home/brokenquark/repo-ansi/debops@debops/ansible/playbooks/app/gitlab.yml,0,1,0,0,0,0,1
2019-03-09 02:07:01.510153, /home/brokenquark/repo-ansi/debops@debops/ansible/playbooks/app/etherpad.yml,0,1,0,0,0,0,1
2019-03-09 02:07:01.571935, /home/brokenquark/repo-ansi/debops@debops/ansible/playbooks/tools/dist-upgrade.yml,1,0,0,0,2,0,3
2019-03-09 02:07:12.233790, /home/brokenquark/repo-ansi/debops@debops-playbooks/playbooks/service/netbox.yml,0,1,0,0,0,0,1
2019-03-09 02:07:12.283851, /home/brokenquark/repo-ansi/debops@debops-playbooks/playbooks/service/gitlab.yml,0,1,0,0,0,0,1
2019-03-09 02:07:12.614298, /home/brokenquark/repo-ansi/debops@debops-playbooks/playbooks/app/netbox.yml,0,1,0,0,0,0,1
2019-03-09 02:07:12.625072, /home/brokenquark/repo-ansi/debops@debops-playbooks/playbooks/app/gitlab.yml,0,1,0,0,0,0,1
2019-03-09 02:07:12.689637, /home/brokenquark/repo-ansi/debops@debops-playbooks/playbooks/tools/dist-upgrade.yml,1,0,0,0,2,0,3
2019-03-09 02:07:12.981686, /home/brokenquark/repo-ansi/dell@idrac-ansible-module/playbooks/manager/set_manager_vlanid.yml,1,0,0,0,0,0,1
2019-03-09 02:08:07.430860, /home/brokenquark/repo-ansi/devananda@bifrost/playbooks/roles/bifrost-prep-for-install/defaults/main.yml,1,0,0,0,0,0,1
2019-03-09 02:08:07.446412, /home/brokenquark/repo-ansi/devananda@bifrost/playbooks/roles/bifrost-ironic-install/defaults/required_defaults_Debian_family.yml,1,0,0,0,0,0,1
2019-03-09 02:08:07.450065, /home/brokenquark/repo-ansi/devananda@bifrost/playbooks/roles/bifrost-ironic-install/defaults/required_defaults_RedHat_family.yml,1,0,0,0,0,0,1
2019-03-09 02:08:07.458635, /home/brokenquark/repo-ansi/devananda@bifrost/playbooks/roles/bifrost-ironic-install/defaults/main.yml,1,1,3,0,0,0,5
2019-03-09 02:08:07.521041, /home/brokenquark/repo-ansi/devananda@bifrost/playbooks/roles/bifrost-ironic-install/tasks/main.yml,4,0,0,0,1,0,5
2019-03-09 02:08:07.584078, /home/brokenquark/repo-ansi/devananda@bifrost/playbooks/roles/bifrost-openstack-ci-prep/defaults/main.yml,1,0,0,0,0,0,1
2019-03-09 02:08:07.587698, /home/brokenquark/repo-ansi/devananda@bifrost/playbooks/roles/bifrost-openstack-ci-prep/tasks/main.yml,2,0,0,0,0,0,2
2019-03-09 02:08:07.637806, /home/brokenquark/repo-ansi/devananda@bifrost/playbooks/roles/bifrost-configdrives-dynamic/defaults/main.yml,1,0,0,0,0,0,1
2019-03-09 02:08:49.218965, /home/brokenquark/repo-ansi/edx@configuration/playbooks/mongo_rolling_upgrade.yml,3,0,0,0,0,0,3
2019-03-09 02:08:49.248861, /home/brokenquark/repo-ansi/edx@configuration/playbooks/create_rds.yml,0,0,0,0,2,0,2
2019-03-09 02:08:49.301006, /home/brokenquark/repo-ansi/edx@configuration/playbooks/promote_rds_secondary.yml,0,1,0,0,0,0,1
2019-03-09 02:08:49.326678, /home/brokenquark/repo-ansi/edx@configuration/playbooks/populate_configuration_model.yml,1,0,0,0,0,0,1
2019-03-09 02:08:49.361735, /home/brokenquark/repo-ansi/edx@configuration/playbooks/edx_provision.yml,3,0,0,0,0,0,3
2019-03-09 02:08:49.381260, /home/brokenquark/repo-ansi/edx@configuration/playbooks/add-ubuntu-key.yml,1,0,0,0,0,0,1
2019-03-09 02:08:49.455502, /home/brokenquark/repo-ansi/edx@configuration/playbooks/remove-ubuntu-key.yml,1,0,0,0,0,0,1
2019-03-09 02:08:49.470310, /home/brokenquark/repo-ansi/edx@configuration/playbooks/analytics-jenkins.yml,1,0,0,0,0,0,1
2019-03-09 02:08:49.507349, /home/brokenquark/repo-ansi/edx@configuration/playbooks/legacy_certificates.yml,2,0,0,0,0,0,2
2019-03-09 02:08:49.595622, /home/brokenquark/repo-ansi/edx@configuration/playbooks/mongo_upgrade_hidden_secondaries.yml,1,0,0,0,1,0,2
2019-03-09 02:08:49.621514, /home/brokenquark/repo-ansi/edx@configuration/playbooks/ora2.yml,3,0,0,0,0,0,3
2019-03-09 02:08:49.774047, /home/brokenquark/repo-ansi/edx@configuration/playbooks/roles/jenkins_master/defaults/main.yml,1,0,0,0,0,0,1
2019-03-09 02:08:49.816538, /home/brokenquark/repo-ansi/edx@configuration/playbooks/roles/jenkins_master/tasks/main.yml,1,0,1,0,4,0,6
2019-03-09 02:08:49.884117, /home/brokenquark/repo-ansi/edx@configuration/playbooks/roles/common/tasks/main.yml,3,0,0,0,1,0,4
2019-03-09 02:08:49.914044, /home/brokenquark/repo-ansi/edx@configuration/playbooks/roles/ad_hoc_reporting/tasks/main.yml,4,0,0,0,0,0,4
2019-03-09 02:08:49.945855, /home/brokenquark/repo-ansi/edx@configuration/playbooks/roles/mongo_3_2/defaults/main.yml,7,0,0,0,0,0,7
2019-03-09 02:08:49.994886, /home/brokenquark/repo-ansi/edx@configuration/playbooks/roles/mongo_3_2/tasks/main.yml,2,0,0,0,0,0,2
2019-03-09 02:08:50.053299, /home/brokenquark/repo-ansi/edx@configuration/playbooks/roles/xserver/defaults/main.yml,2,0,0,0,0,0,2
2019-03-09 02:08:50.073272, /home/brokenquark/repo-ansi/edx@configuration/playbooks/roles/xserver/tasks/deploy.yml,2,0,0,0,0,0,2
2019-03-09 02:08:50.082133, /home/brokenquark/repo-ansi/edx@configuration/playbooks/roles/xserver/tasks/main.yml,1,0,0,0,0,0,1
2019-03-09 02:08:50.089974, /home/brokenquark/repo-ansi/edx@configuration/playbooks/roles/test_build_server/defaults/main.yml,1,0,0,0,0,0,1
2019-03-09 02:08:50.099866, /home/brokenquark/repo-ansi/edx@configuration/playbooks/roles/aws/defaults/main.yml,0,0,0,0,2,0,2
2019-03-09 02:08:50.112750, /home/brokenquark/repo-ansi/edx@configuration/playbooks/roles/aws/tasks/main.yml,4,0,0,0,2,0,6
2019-03-09 02:08:50.129570, /home/brokenquark/repo-ansi/edx@configuration/playbooks/roles/forum/defaults/main.yml,3,0,0,1,0,0,4
2019-03-09 02:08:50.148774, /home/brokenquark/repo-ansi/edx@configuration/playbooks/roles/forum/tasks/deploy.yml,1,0,0,0,0,0,1
2019-03-09 02:08:50.158596, /home/brokenquark/repo-ansi/edx@configuration/playbooks/roles/forum/tasks/main.yml,2,0,0,0,0,0,2
2019-03-09 02:08:50.168010, /home/brokenquark/repo-ansi/edx@configuration/playbooks/roles/go-agent/defaults/main.yml,1,0,0,0,0,0,1
2019-03-09 02:08:50.181576, /home/brokenquark/repo-ansi/edx@configuration/playbooks/roles/simple_theme/defaults/main.yml,0,0,0,0,1,0,1
2019-03-09 02:08:50.199611, /home/brokenquark/repo-ansi/edx@configuration/playbooks/roles/simple_theme/tasks/deploy.yml,0,0,0,0,1,0,1
2019-03-09 02:08:50.201095, /home/brokenquark/repo-ansi/edx@configuration/playbooks/roles/simple_theme/tasks/main.yml,0,0,0,0,1,0,1
2019-03-09 02:08:50.211783, /home/brokenquark/repo-ansi/edx@configuration/playbooks/roles/registrar/defaults/main.yml,5,0,0,0,0,0,5
2019-03-09 02:08:50.285924, /home/brokenquark/repo-ansi/edx@configuration/playbooks/roles/edx_django_service/defaults/main.yml,2,0,0,0,0,0,2
2019-03-09 02:08:50.319488, /home/brokenquark/repo-ansi/edx@configuration/playbooks/roles/edx_django_service/tasks/main.yml,2,0,0,0,0,0,2
2019-03-09 02:08:50.340703, /home/brokenquark/repo-ansi/edx@configuration/playbooks/roles/hadoop_common/defaults/main.yml,1,0,0,0,0,0,1
2019-03-09 02:08:50.379702, /home/brokenquark/repo-ansi/edx@configuration/playbooks/roles/hadoop_common/tasks/main.yml,4,0,0,0,2,0,6
2019-03-09 02:08:50.426729, /home/brokenquark/repo-ansi/edx@configuration/playbooks/roles/jenkins_build/defaults/main.yml,2,0,0,0,0,0,2
2019-03-09 02:08:50.435588, /home/brokenquark/repo-ansi/edx@configuration/playbooks/roles/redis/defaults/main.yml,1,1,0,0,0,0,2
2019-03-09 02:08:50.438936, /home/brokenquark/repo-ansi/edx@configuration/playbooks/roles/redis/tasks/main.yml,1,0,0,0,0,0,1
2019-03-09 02:08:50.456721, /home/brokenquark/repo-ansi/edx@configuration/playbooks/roles/git_clone/tasks/main.yml,1,0,0,0,0,0,1
2019-03-09 02:08:50.460631, /home/brokenquark/repo-ansi/edx@configuration/playbooks/roles/elasticsearch/defaults/main.yml,1,0,0,0,0,0,1
2019-03-09 02:08:50.477391, /home/brokenquark/repo-ansi/edx@configuration/playbooks/roles/testcourses/tasks/import_course.yml,1,0,0,0,0,0,1
2019-03-09 02:08:50.486450, /home/brokenquark/repo-ansi/edx@configuration/playbooks/roles/antivirus/defaults/main.yml,1,0,0,0,0,0,1
2019-03-09 02:08:50.517534, /home/brokenquark/repo-ansi/edx@configuration/playbooks/roles/logstash/tasks/main.yml,2,0,0,0,0,0,2
2019-03-09 02:08:50.543015, /home/brokenquark/repo-ansi/edx@configuration/playbooks/roles/flower/defaults/main.yml,4,0,0,1,0,0,5
2019-03-09 02:08:50.575805, /home/brokenquark/repo-ansi/edx@configuration/playbooks/roles/devpi_consumer/defaults/main.yml,1,0,0,0,0,0,1
2019-03-09 02:08:50.581893, /home/brokenquark/repo-ansi/edx@configuration/playbooks/roles/veda_ffmpeg/defaults/main.yml,1,0,0,0,0,0,1
2019-03-09 02:08:50.604803, /home/brokenquark/repo-ansi/edx@configuration/playbooks/roles/go-server/defaults/main.yml,3,3,0,0,0,0,6
2019-03-09 02:08:50.610396, /home/brokenquark/repo-ansi/edx@configuration/playbooks/roles/go-server/tasks/setup_regular_backup.yml,1,0,0,0,0,0,1
2019-03-09 02:08:50.648159, /home/brokenquark/repo-ansi/edx@configuration/playbooks/roles/go-server/tasks/main.yml,1,0,0,0,0,0,1
2019-03-09 02:08:50.671754, /home/brokenquark/repo-ansi/edx@configuration/playbooks/roles/gh_mirror/defaults/main.yml,1,0,0,0,0,0,1
2019-03-09 02:08:50.687403, /home/brokenquark/repo-ansi/edx@configuration/playbooks/roles/sqoop/defaults/main.yml,0,0,2,0,0,0,2
2019-03-09 02:08:50.726142, /home/brokenquark/repo-ansi/edx@configuration/playbooks/roles/common_vars/defaults/main.yml,11,1,1,0,0,0,13
2019-03-09 02:08:50.729964, /home/brokenquark/repo-ansi/edx@configuration/playbooks/roles/edx-sandbox/tasks/main.yml,1,0,0,0,0,0,1
2019-03-09 02:08:50.736871, /home/brokenquark/repo-ansi/edx@configuration/playbooks/roles/server_utils/tasks/main.yml,0,0,0,0,1,0,1
2019-03-09 02:08:50.760050, /home/brokenquark/repo-ansi/edx@configuration/playbooks/roles/graphite/defaults/main.yml,4,0,0,1,0,0,5
2019-03-09 02:08:50.822142, /home/brokenquark/repo-ansi/edx@configuration/playbooks/roles/tools_jenkins/defaults/main.yml,0,0,0,0,1,0,1
2019-03-09 02:08:50.850944, /home/brokenquark/repo-ansi/edx@configuration/playbooks/roles/devpi/defaults/main.yml,1,0,0,0,0,0,1
2019-03-09 02:08:50.884897, /home/brokenquark/repo-ansi/edx@configuration/playbooks/roles/rbenv/tasks/main.yml,2,0,0,0,0,0,2
2019-03-09 02:08:50.905166, /home/brokenquark/repo-ansi/edx@configuration/playbooks/roles/user/defaults/main.yml,0,0,0,0,1,0,1
2019-03-09 02:08:50.936851, /home/brokenquark/repo-ansi/edx@configuration/playbooks/roles/user/tasks/main.yml,4,0,0,0,0,0,4
2019-03-09 02:08:50.958272, /home/brokenquark/repo-ansi/edx@configuration/playbooks/roles/video_pipeline_base/defaults/main.yml,9,0,0,0,0,0,9
2019-03-09 02:08:50.991497, /home/brokenquark/repo-ansi/edx@configuration/playbooks/roles/ecommerce/defaults/main.yml,10,0,0,0,0,0,10
2019-03-09 02:08:51.013460, /home/brokenquark/repo-ansi/edx@configuration/playbooks/roles/alton/defaults/main.yml,6,0,0,0,0,0,6
2019-03-09 02:08:51.023680, /home/brokenquark/repo-ansi/edx@configuration/playbooks/roles/alton/tasks/deploy.yml,1,0,0,0,0,0,1
2019-03-09 02:08:51.038236, /home/brokenquark/repo-ansi/edx@configuration/playbooks/roles/haproxy/tasks/main.yml,1,0,0,0,0,0,1
2019-03-09 02:08:51.054110, /home/brokenquark/repo-ansi/edx@configuration/playbooks/roles/gluster/tasks/main.yml,0,0,0,0,1,0,1
2019-03-09 02:08:51.058754, /home/brokenquark/repo-ansi/edx@configuration/playbooks/roles/android_sdk/defaults/main.yml,1,0,0,0,0,0,1
2019-03-09 02:08:51.072739, /home/brokenquark/repo-ansi/edx@configuration/playbooks/roles/swapfile/defaults/main.yml,0,0,0,0,1,0,1
2019-03-09 02:08:51.110541, /home/brokenquark/repo-ansi/edx@configuration/playbooks/roles/certs/defaults/main.yml,4,0,0,0,0,0,4
2019-03-09 02:08:51.127398, /home/brokenquark/repo-ansi/edx@configuration/playbooks/roles/certs/tasks/deploy.yml,2,0,0,0,0,0,2
2019-03-09 02:08:51.146715, /home/brokenquark/repo-ansi/edx@configuration/playbooks/roles/demo/defaults/main.yml,12,0,0,0,0,0,12
2019-03-09 02:08:51.157885, /home/brokenquark/repo-ansi/edx@configuration/playbooks/roles/demo/tasks/deploy.yml,1,0,0,0,0,0,1
2019-03-09 02:08:51.165387, /home/brokenquark/repo-ansi/edx@configuration/playbooks/roles/oraclejdk/defaults/main.yml,0,0,1,0,0,0,1
2019-03-09 02:08:51.173774, /home/brokenquark/repo-ansi/edx@configuration/playbooks/roles/oraclejdk/tasks/main.yml,2,0,0,0,0,0,2
2019-03-09 02:08:51.183725, /home/brokenquark/repo-ansi/edx@configuration/playbooks/roles/munin_node/tasks/main.yml,3,0,0,0,0,0,3
2019-03-09 02:08:51.193153, /home/brokenquark/repo-ansi/edx@configuration/playbooks/roles/splunkforwarder/defaults/main.yml,0,1,0,0,0,0,1
2019-03-09 02:08:51.211050, /home/brokenquark/repo-ansi/edx@configuration/playbooks/roles/splunkforwarder/tasks/main.yml,6,0,0,0,0,0,6
2019-03-09 02:08:51.231613, /home/brokenquark/repo-ansi/edx@configuration/playbooks/roles/notifier/defaults/main.yml,2,3,0,0,0,0,5
2019-03-09 02:08:51.253631, /home/brokenquark/repo-ansi/edx@configuration/playbooks/roles/notifier/tasks/deploy.yml,2,0,0,0,0,0,2
2019-03-09 02:08:51.292057, /home/brokenquark/repo-ansi/edx@configuration/playbooks/roles/notifier/tasks/main.yml,1,0,0,0,0,0,1
2019-03-09 02:08:51.317785, /home/brokenquark/repo-ansi/edx@configuration/playbooks/roles/mysql/tasks/mysql.yml,1,0,0,0,0,0,1
2019-03-09 02:08:51.321691, /home/brokenquark/repo-ansi/edx@configuration/playbooks/roles/automated/defaults/main.yml,1,0,0,0,0,0,1
2019-03-09 02:08:51.336562, /home/brokenquark/repo-ansi/edx@configuration/playbooks/roles/automated/tasks/main.yml,1,0,0,0,0,0,1
2019-03-09 02:08:51.343951, /home/brokenquark/repo-ansi/edx@configuration/playbooks/roles/edx_ansible/defaults/main.yml,1,0,0,0,0,0,1
2019-03-09 02:08:51.359762, /home/brokenquark/repo-ansi/edx@configuration/playbooks/roles/edx_ansible/tasks/deploy.yml,1,0,0,0,0,0,1
2019-03-09 02:08:51.385819, /home/brokenquark/repo-ansi/edx@configuration/playbooks/roles/security/tasks/security-ubuntu.yml,2,0,0,0,1,0,3
2019-03-09 02:08:51.404999, /home/brokenquark/repo-ansi/edx@configuration/playbooks/roles/add_user/tasks/main.yml,2,0,0,0,0,0,2
2019-03-09 02:08:51.410417, /home/brokenquark/repo-ansi/edx@configuration/playbooks/roles/neo4j/defaults/main.yml,4,0,0,1,0,0,5
2019-03-09 02:08:51.430178, /home/brokenquark/repo-ansi/edx@configuration/playbooks/roles/neo4j/tasks/main.yml,2,0,0,0,0,0,2
2019-03-09 02:08:51.432981, /home/brokenquark/repo-ansi/edx@configuration/playbooks/roles/datadog-uninstall/defaults/main.yml,1,0,1,0,0,0,2
2019-03-09 02:08:51.435627, /home/brokenquark/repo-ansi/edx@configuration/playbooks/roles/datadog-uninstall/tasks/main.yml,1,0,0,0,0,0,1
2019-03-09 02:08:51.436879, /home/brokenquark/repo-ansi/edx@configuration/playbooks/roles/snort/defaults/main.yml,0,0,2,0,0,1,3
2019-03-09 02:08:51.443949, /home/brokenquark/repo-ansi/edx@configuration/playbooks/roles/snort/tasks/main.yml,4,0,0,0,0,0,4
2019-03-09 02:08:51.460166, /home/brokenquark/repo-ansi/edx@configuration/playbooks/roles/mariadb/defaults/main.yml,3,0,0,0,0,0,3
2019-03-09 02:08:51.475861, /home/brokenquark/repo-ansi/edx@configuration/playbooks/roles/mariadb/tasks/main.yml,2,0,0,0,0,0,2
2019-03-09 02:08:51.484763, /home/brokenquark/repo-ansi/edx@configuration/playbooks/roles/mariadb/tasks/cluster.yml,2,1,0,0,0,0,3
2019-03-09 02:08:51.494127, /home/brokenquark/repo-ansi/edx@configuration/playbooks/roles/kibana/tasks/main.yml,2,0,0,0,0,0,2
2019-03-09 02:08:51.508008, /home/brokenquark/repo-ansi/edx@configuration/playbooks/roles/minos/tasks/main.yml,2,0,0,0,0,0,2
2019-03-09 02:08:51.510558, /home/brokenquark/repo-ansi/edx@configuration/playbooks/roles/minos/meta/main.yml,1,0,0,0,0,0,1
2019-03-09 02:08:51.514210, /home/brokenquark/repo-ansi/edx@configuration/playbooks/roles/openstack/defaults/main.yml,0,1,0,0,1,0,2
2019-03-09 02:08:51.525246, /home/brokenquark/repo-ansi/edx@configuration/playbooks/roles/openstack/tasks/main.yml,2,0,0,0,0,0,2
2019-03-09 02:08:51.581360, /home/brokenquark/repo-ansi/edx@configuration/playbooks/roles/jenkins_analytics/defaults/main.yml,9,2,0,0,0,0,11
2019-03-09 02:08:51.608018, /home/brokenquark/repo-ansi/edx@configuration/playbooks/roles/jenkins_analytics/tasks/main.yml,4,0,0,0,0,0,4
2019-03-09 02:08:51.642119, /home/brokenquark/repo-ansi/edx@configuration/playbooks/roles/gitreload/defaults/main.yml,1,0,0,0,0,0,1
2019-03-09 02:08:51.656461, /home/brokenquark/repo-ansi/edx@configuration/playbooks/roles/gitreload/tasks/deploy.yml,1,0,0,0,0,0,1
2019-03-09 02:08:51.680327, /home/brokenquark/repo-ansi/edx@configuration/playbooks/roles/devstack_sqlite_fix/defaults/main.yml,0,0,0,0,0,1,1
2019-03-09 02:08:51.703205, /home/brokenquark/repo-ansi/edx@configuration/playbooks/roles/locust/defaults/main.yml,1,0,0,0,0,0,1
2019-03-09 02:08:51.711413, /home/brokenquark/repo-ansi/edx@configuration/playbooks/roles/locust/tasks/main.yml,2,0,0,0,1,0,3
2019-03-09 02:08:51.732772, /home/brokenquark/repo-ansi/edx@configuration/playbooks/roles/mongo_3_4/defaults/main.yml,7,0,0,0,0,0,7
2019-03-09 02:08:51.787802, /home/brokenquark/repo-ansi/edx@configuration/playbooks/roles/mongo_3_4/tasks/main.yml,2,0,0,0,0,0,2
2019-03-09 02:08:51.797497, /home/brokenquark/repo-ansi/edx@configuration/playbooks/roles/s3fs/defaults/main.yml,0,0,1,0,0,0,1
2019-03-09 02:08:51.808433, /home/brokenquark/repo-ansi/edx@configuration/playbooks/roles/prospectus/defaults/main.yml,2,0,0,0,0,0,2
2019-03-09 02:08:51.832992, /home/brokenquark/repo-ansi/edx@configuration/playbooks/roles/prospectus/tasks/main.yml,2,0,0,0,1,0,3
2019-03-09 02:08:52.052471, /home/brokenquark/repo-ansi/edx@configuration/playbooks/roles/edxapp/defaults/main.yml,33,4,6,1,0,0,44
2019-03-09 02:08:52.064484, /home/brokenquark/repo-ansi/edx@configuration/playbooks/roles/edxapp/tasks/python_sandbox_env.yml,2,0,0,0,0,0,2
2019-03-09 02:08:52.124787, /home/brokenquark/repo-ansi/edx@configuration/playbooks/roles/edxapp/tasks/deploy.yml,2,0,0,0,2,0,4
2019-03-09 02:08:52.151654, /home/brokenquark/repo-ansi/edx@configuration/playbooks/roles/edxapp/tasks/service_variant_config.yml,0,0,0,0,1,0,1
2019-03-09 02:08:52.170359, /home/brokenquark/repo-ansi/edx@configuration/playbooks/roles/edxapp/tasks/main.yml,2,0,0,0,0,0,2
2019-03-09 02:08:52.191014, /home/brokenquark/repo-ansi/edx@configuration/playbooks/roles/edx_notes_api/defaults/main.yml,3,0,0,0,0,0,3
2019-03-09 02:08:52.237495, /home/brokenquark/repo-ansi/edx@configuration/playbooks/roles/rabbitmq/defaults/main.yml,5,0,0,0,0,0,5
2019-03-09 02:08:52.275198, /home/brokenquark/repo-ansi/edx@configuration/playbooks/roles/rabbitmq/tasks/main.yml,7,0,0,0,1,0,8
2019-03-09 02:08:52.282093, /home/brokenquark/repo-ansi/edx@configuration/playbooks/roles/analytics_pipeline/defaults/main.yml,2,0,0,0,0,0,2
2019-03-09 02:08:52.341995, /home/brokenquark/repo-ansi/edx@configuration/playbooks/roles/insights/defaults/main.yml,7,0,1,0,0,0,8
2019-03-09 02:08:52.374194, /home/brokenquark/repo-ansi/edx@configuration/playbooks/roles/splunk-server/defaults/main.yml,4,1,0,0,0,0,5
2019-03-09 02:08:52.402644, /home/brokenquark/repo-ansi/edx@configuration/playbooks/roles/splunk-server/tasks/main.yml,6,0,0,0,0,0,6
2019-03-09 02:08:52.420845, /home/brokenquark/repo-ansi/edx@configuration/playbooks/roles/ecomworker/defaults/main.yml,5,0,0,0,0,0,5
2019-03-09 02:08:52.446631, /home/brokenquark/repo-ansi/edx@configuration/playbooks/roles/mount_ebs/tasks/main.yml,0,0,0,0,2,0,2
2019-03-09 02:08:52.456056, /home/brokenquark/repo-ansi/edx@configuration/playbooks/roles/supervisor/defaults/main.yml,1,0,0,0,0,0,1
2019-03-09 02:08:52.482284, /home/brokenquark/repo-ansi/edx@configuration/playbooks/roles/supervisor/tasks/main.yml,2,0,0,0,0,0,2
2019-03-09 02:08:52.493924, /home/brokenquark/repo-ansi/edx@configuration/playbooks/roles/oauth2_proxy/defaults/main.yml,5,0,0,1,0,0,6
2019-03-09 02:08:52.512118, /home/brokenquark/repo-ansi/edx@configuration/playbooks/roles/oauth2_proxy/tasks/main.yml,2,0,0,0,0,0,2
2019-03-09 02:08:52.522134, /home/brokenquark/repo-ansi/edx@configuration/playbooks/roles/browsers/defaults/main.yml,0,0,1,0,0,4,5
2019-03-09 02:08:52.551398, /home/brokenquark/repo-ansi/edx@configuration/playbooks/roles/browsers/tasks/main.yml,2,0,0,0,0,0,2
2019-03-09 02:08:52.555511, /home/brokenquark/repo-ansi/edx@configuration/playbooks/roles/postfix_queue/defaults/main.yml,0,1,0,0,5,0,6
2019-03-09 02:08:52.564346, /home/brokenquark/repo-ansi/edx@configuration/playbooks/roles/postfix_queue/tasks/main.yml,2,0,0,0,2,0,4
2019-03-09 02:08:52.582487, /home/brokenquark/repo-ansi/edx@configuration/playbooks/roles/journals/defaults/main.yml,3,1,0,0,0,0,4
2019-03-09 02:08:52.600834, /home/brokenquark/repo-ansi/edx@configuration/playbooks/roles/nltk/defaults/main.yml,0,0,3,0,0,3,6
2019-03-09 02:08:52.650777, /home/brokenquark/repo-ansi/edx@configuration/playbooks/roles/analytics_api/defaults/main.yml,6,0,0,0,0,0,6
2019-03-09 02:08:52.663251, /home/brokenquark/repo-ansi/edx@configuration/playbooks/roles/go-agent-docker-server/tasks/main.yml,1,0,0,0,0,0,1
2019-03-09 02:08:52.688653, /home/brokenquark/repo-ansi/edx@configuration/playbooks/roles/jenkins_admin/tasks/main.yml,1,0,0,0,0,0,1
2019-03-09 02:08:52.701268, /home/brokenquark/repo-ansi/edx@configuration/playbooks/roles/mongo_3_0/defaults/main.yml,7,0,0,0,0,0,7
2019-03-09 02:08:52.742156, /home/brokenquark/repo-ansi/edx@configuration/playbooks/roles/mongo_3_0/tasks/main.yml,2,0,0,0,0,0,2
2019-03-09 02:08:52.765113, /home/brokenquark/repo-ansi/edx@configuration/playbooks/roles/discovery/defaults/main.yml,3,1,0,0,0,0,4
2019-03-09 02:08:52.787873, /home/brokenquark/repo-ansi/edx@configuration/playbooks/roles/apache/tasks/main.yml,3,0,0,0,0,0,3
2019-03-09 02:08:52.812460, /home/brokenquark/repo-ansi/edx@configuration/playbooks/roles/xqwatcher/tasks/code_jail.yml,3,0,0,0,1,0,4
2019-03-09 02:08:52.840075, /home/brokenquark/repo-ansi/edx@configuration/playbooks/roles/jenkins_worker/defaults/main.yml,1,0,0,0,0,1,2
2019-03-09 02:08:52.846503, /home/brokenquark/repo-ansi/edx@configuration/playbooks/roles/jenkins_worker/tasks/system.yml,0,0,0,0,1,0,1
2019-03-09 02:08:52.850409, /home/brokenquark/repo-ansi/edx@configuration/playbooks/roles/jenkins_worker/tasks/test_platform_worker.yml,0,0,0,0,1,0,1
2019-03-09 02:08:52.886634, /home/brokenquark/repo-ansi/edx@configuration/playbooks/roles/jenkins_worker/meta/main.yml,1,0,0,0,0,0,1
2019-03-09 02:08:52.890665, /home/brokenquark/repo-ansi/edx@configuration/playbooks/roles/aide/tasks/main.yml,1,0,0,0,0,0,1
2019-03-09 02:08:52.940555, /home/brokenquark/repo-ansi/edx@configuration/playbooks/roles/jenkins_data_engineering/defaults/main.yml,5,0,0,0,0,0,5
2019-03-09 02:08:52.965936, /home/brokenquark/repo-ansi/edx@configuration/playbooks/roles/datadog/defaults/main.yml,1,0,0,0,0,0,1
2019-03-09 02:08:52.972510, /home/brokenquark/repo-ansi/edx@configuration/playbooks/roles/datadog/tasks/main.yml,1,0,0,0,0,0,1
2019-03-09 02:08:52.977234, /home/brokenquark/repo-ansi/edx@configuration/playbooks/roles/vhost/defaults/main.yml,3,0,0,0,0,0,3
2019-03-09 02:08:52.987513, /home/brokenquark/repo-ansi/edx@configuration/playbooks/roles/vhost/tasks/main.yml,3,0,0,0,0,0,3
2019-03-09 02:08:53.006786, /home/brokenquark/repo-ansi/edx@configuration/playbooks/roles/xqueue/defaults/main.yml,3,0,0,0,0,0,3
2019-03-09 02:08:53.082670, /home/brokenquark/repo-ansi/edx@configuration/playbooks/roles/grafana/defaults/main.yml,19,2,0,0,0,0,21
2019-03-09 02:08:53.091278, /home/brokenquark/repo-ansi/edx@configuration/playbooks/roles/grafana/tasks/main.yml,1,0,0,0,0,0,1
2019-03-09 02:08:53.114653, /home/brokenquark/repo-ansi/edx@configuration/playbooks/roles/nginx/defaults/main.yml,2,0,0,1,0,0,3
2019-03-09 02:08:53.161676, /home/brokenquark/repo-ansi/edx@configuration/playbooks/roles/nginx/tasks/main.yml,16,1,1,0,0,0,18
2019-03-09 02:08:53.171208, /home/brokenquark/repo-ansi/edx@configuration/playbooks/roles/mongo_2_6/defaults/main.yml,7,0,0,0,0,0,7
2019-03-09 02:08:53.200998, /home/brokenquark/repo-ansi/edx@configuration/playbooks/roles/mongo_2_6/tasks/main.yml,3,0,0,0,0,0,3
2019-03-09 02:08:53.205623, /home/brokenquark/repo-ansi/edx@configuration/playbooks/roles/shibboleth/defaults/main.yml,3,0,1,0,0,0,4
2019-03-09 02:08:53.211388, /home/brokenquark/repo-ansi/edx@configuration/playbooks/roles/shibboleth/tasks/main.yml,1,0,0,0,0,0,1
2019-03-09 02:08:53.228638, /home/brokenquark/repo-ansi/edx@configuration/playbooks/roles/credentials/defaults/main.yml,6,0,0,0,1,0,7
2019-03-09 02:08:53.246818, /home/brokenquark/repo-ansi/edx@configuration/playbooks/roles/edx_maintenance/tasks/main.yml,1,0,0,0,0,0,1
2019-03-09 02:08:53.264839, /home/brokenquark/repo-ansi/edx@configuration/playbooks/roles/newrelic_infrastructure/tasks/main.yml,1,0,0,0,0,0,1
2019-03-09 02:08:53.265926, /home/brokenquark/repo-ansi/edx@configuration/playbooks/roles/jscover/defaults/main.yml,0,0,1,0,0,0,1
2019-03-09 02:08:53.308501, /home/brokenquark/repo-ansi/edx@configuration/playbooks/roles/jenkins_it/defaults/main.yml,2,0,0,0,0,0,2
2019-03-09 02:08:53.314075, /home/brokenquark/repo-ansi/edx@configuration/playbooks/roles/jenkins_it/tasks/main.yml,1,0,0,0,0,0,1
2019-03-09 02:08:53.334528, /home/brokenquark/repo-ansi/edx@configuration/playbooks/roles/edx_service/tasks/main.yml,1,0,0,0,0,0,1
2019-03-09 02:08:53.343862, /home/brokenquark/repo-ansi/edx@configuration/playbooks/roles/hive/defaults/main.yml,2,0,1,0,0,0,3
2019-03-09 02:08:53.363480, /home/brokenquark/repo-ansi/edx@configuration/playbooks/roles/local_dev/defaults/main.yml,1,0,0,0,0,0,1
2019-03-09 02:08:53.378610, /home/brokenquark/repo-ansi/edx@configuration/playbooks/roles/local_dev/tasks/main.yml,1,0,0,0,0,0,1
2019-03-09 02:08:53.408122, /home/brokenquark/repo-ansi/edx@configuration/playbooks/roles/jenkins_common/defaults/main.yml,1,4,1,0,0,0,6
2019-03-09 02:08:53.454003, /home/brokenquark/repo-ansi/edx@configuration/playbooks/roles/jenkins_common/tasks/main.yml,2,0,0,0,0,0,2
2019-03-09 02:08:53.460586, /home/brokenquark/repo-ansi/edx@configuration/playbooks/roles/cassandra/defaults/main.yml,1,0,0,0,0,0,1
2019-03-09 02:08:53.469088, /home/brokenquark/repo-ansi/edx@configuration/playbooks/roles/cassandra/tasks/main.yml,0,0,1,0,0,0,1
2019-03-09 02:08:53.507759, /home/brokenquark/repo-ansi/edx@configuration/playbooks/sample_vars/passwords.yml,3,42,0,0,0,0,45
2019-03-09 02:08:53.518226, /home/brokenquark/repo-ansi/edx@configuration/playbooks/sample_vars/test-mongo.yml,12,0,0,0,0,0,12
2019-03-09 02:09:24.900618, /home/brokenquark/repo-ansi/enterprisemediawiki@Meza1/src/playbooks/site.yml,5,0,0,0,0,0,5
2019-03-09 02:09:25.604267, /home/brokenquark/repo-ansi/enterprisemediawiki@meza/src/playbooks/site.yml,5,0,0,0,0,0,5
2019-03-09 02:09:26.180958, /home/brokenquark/repo-ansi/epfl-idevelop@jahia2wp/ansible/playbooks/wordpress-main.yml,1,0,0,0,0,0,1
2019-03-09 02:09:38.671089, /home/brokenquark/repo-ansi/frappe@bench/playbooks/macosx.yml,1,0,0,0,0,0,1
2019-03-09 02:09:38.681494, /home/brokenquark/repo-ansi/frappe@bench/playbooks/site.yml,1,0,0,0,0,0,1
2019-03-09 02:09:38.683307, /home/brokenquark/repo-ansi/frappe@bench/playbooks/vm_build.yml,1,0,0,0,0,0,1
2019-03-09 02:09:38.686804, /home/brokenquark/repo-ansi/frappe@bench/playbooks/create_user.yml,2,0,0,0,0,0,2
2019-03-09 02:09:38.691097, /home/brokenquark/repo-ansi/frappe@bench/playbooks/roles/common/tasks/debian_family.yml,1,0,0,0,0,0,1
2019-03-09 02:09:38.701447, /home/brokenquark/repo-ansi/frappe@bench/playbooks/roles/common/tasks/macos.yml,1,0,0,0,0,0,1
2019-03-09 02:09:38.705918, /home/brokenquark/repo-ansi/frappe@bench/playbooks/roles/common/tasks/redhat_family.yml,2,0,0,0,0,1,3
2019-03-09 02:09:38.711623, /home/brokenquark/repo-ansi/frappe@bench/playbooks/roles/nodejs/tasks/main.yml,1,0,0,0,0,0,1
2019-03-09 02:09:38.727336, /home/brokenquark/repo-ansi/frappe@bench/playbooks/roles/bench/tasks/setup_bench_production.yml,3,0,0,0,0,0,3
2019-03-09 02:09:38.729681, /home/brokenquark/repo-ansi/frappe@bench/playbooks/roles/bench/tasks/change_ssh_port.yml,1,0,0,0,0,0,1
2019-03-09 02:09:38.739772, /home/brokenquark/repo-ansi/frappe@bench/playbooks/roles/bench/tasks/main.yml,1,0,0,0,0,0,1
2019-03-09 02:09:38.749928, /home/brokenquark/repo-ansi/frappe@bench/playbooks/roles/bench/tasks/setup_firewall.yml,1,0,0,0,0,0,1
2019-03-09 02:09:38.758553, /home/brokenquark/repo-ansi/frappe@bench/playbooks/roles/wkhtmltopdf/tasks/main.yml,2,0,0,0,1,0,3
2019-03-09 02:09:38.768071, /home/brokenquark/repo-ansi/frappe@bench/playbooks/roles/mariadb/tasks/debian.yml,2,0,0,0,0,0,2
2019-03-09 02:09:38.777233, /home/brokenquark/repo-ansi/frappe@bench/playbooks/roles/mariadb/tasks/ubuntu-trusty.yml,1,0,0,0,0,0,1
2019-03-09 02:09:38.780537, /home/brokenquark/repo-ansi/frappe@bench/playbooks/roles/mariadb/tasks/ubuntu-xenial_bionic.yml,1,0,0,0,0,0,1
2019-03-09 02:09:38.789032, /home/brokenquark/repo-ansi/frappe@bench/playbooks/roles/mariadb/tasks/main.yml,2,0,0,0,0,0,2
2019-03-09 02:09:38.822303, /home/brokenquark/repo-ansi/frappe@bench/playbooks/roles/fail2ban/tasks/configure_nginx_jail.yml,1,0,0,0,0,0,1
2019-03-09 02:09:38.824418, /home/brokenquark/repo-ansi/frappe@bench/playbooks/roles/nginx/vars/Debian.yml,1,0,0,0,0,0,1
2019-03-09 02:09:38.825662, /home/brokenquark/repo-ansi/frappe@bench/playbooks/roles/nginx/vars/RedHat.yml,1,0,0,0,0,0,1
2019-03-09 02:09:38.827090, /home/brokenquark/repo-ansi/frappe@bench/playbooks/roles/nginx/tests/test.yml,1,0,0,0,0,0,1
2019-03-09 02:09:38.842327, /home/brokenquark/repo-ansi/frappe@bench/playbooks/roles/nginx/tasks/main.yml,2,0,0,0,0,0,2
2019-03-09 02:09:38.843999, /home/brokenquark/repo-ansi/frappe@bench/playbooks/roles/nginx/tasks/setup-RedHat.yml,1,0,0,0,0,0,1
2019-03-09 02:09:38.846736, /home/brokenquark/repo-ansi/frappe@bench/playbooks/roles/nginx/tasks/setup-Debian.yml,0,0,1,0,0,0,1
2019-03-09 02:09:40.697958, /home/brokenquark/repo-ansi/gashac03@ubuntu/playbooks/roles/jenkins_master/defaults/main.yml,1,0,1,0,0,0,2
2019-03-09 02:09:40.712908, /home/brokenquark/repo-ansi/gashac03@ubuntu/playbooks/roles/jenkins_master/tasks/main.yml,0,0,1,0,3,0,4
2019-03-09 02:09:40.738828, /home/brokenquark/repo-ansi/gashac03@ubuntu/playbooks/roles/common/tasks/main.yml,2,0,0,0,1,0,3
2019-03-09 02:09:40.763115, /home/brokenquark/repo-ansi/gashac03@ubuntu/playbooks/roles/ad_hoc_reporting/tasks/main.yml,4,0,0,0,0,0,4
2019-03-09 02:09:40.766582, /home/brokenquark/repo-ansi/gashac03@ubuntu/playbooks/roles/harprofiler/defaults/main.yml,1,0,0,0,0,0,1
2019-03-09 02:09:40.809225, /home/brokenquark/repo-ansi/gashac03@ubuntu/playbooks/roles/edx_service_rds/defaults/main.yml,2,0,0,4,0,0,6
2019-03-09 02:09:40.844821, /home/brokenquark/repo-ansi/gashac03@ubuntu/playbooks/roles/newrelic-npi/defaults/main.yml,1,0,0,0,0,0,1
2019-03-09 02:09:40.860672, /home/brokenquark/repo-ansi/gashac03@ubuntu/playbooks/roles/xserver/defaults/main.yml,2,0,0,0,0,0,2
2019-03-09 02:09:40.883940, /home/brokenquark/repo-ansi/gashac03@ubuntu/playbooks/roles/test_build_server/defaults/main.yml,1,0,0,0,0,0,1
2019-03-09 02:09:40.893613, /home/brokenquark/repo-ansi/gashac03@ubuntu/playbooks/roles/aws/defaults/main.yml,3,0,1,0,1,1,6
2019-03-09 02:09:40.904666, /home/brokenquark/repo-ansi/gashac03@ubuntu/playbooks/roles/aws/tasks/main.yml,1,0,0,0,2,0,3
2019-03-09 02:09:40.916382, /home/brokenquark/repo-ansi/gashac03@ubuntu/playbooks/roles/forum/defaults/main.yml,3,0,0,1,0,0,4
2019-03-09 02:09:40.953958, /home/brokenquark/repo-ansi/gashac03@ubuntu/playbooks/roles/hadoop_common/defaults/main.yml,1,0,0,0,0,0,1
2019-03-09 02:09:40.971929, /home/brokenquark/repo-ansi/gashac03@ubuntu/playbooks/roles/hadoop_common/tasks/main.yml,1,0,0,0,0,0,1
2019-03-09 02:09:40.992704, /home/brokenquark/repo-ansi/gashac03@ubuntu/playbooks/roles/ora/defaults/main.yml,7,0,0,0,0,0,7
2019-03-09 02:09:41.014487, /home/brokenquark/repo-ansi/gashac03@ubuntu/playbooks/roles/redis/defaults/main.yml,1,1,0,0,0,0,2
2019-03-09 02:09:41.021379, /home/brokenquark/repo-ansi/gashac03@ubuntu/playbooks/roles/elasticsearch/defaults/main.yml,1,0,0,0,0,0,1
2019-03-09 02:09:41.033580, /home/brokenquark/repo-ansi/gashac03@ubuntu/playbooks/roles/antivirus/defaults/main.yml,1,0,0,0,0,0,1
2019-03-09 02:09:41.055209, /home/brokenquark/repo-ansi/gashac03@ubuntu/playbooks/roles/flower/defaults/main.yml,4,0,0,1,0,0,5
2019-03-09 02:09:41.066991, /home/brokenquark/repo-ansi/gashac03@ubuntu/playbooks/roles/gh_mirror/defaults/main.yml,1,0,0,0,0,0,1
2019-03-09 02:09:41.078373, /home/brokenquark/repo-ansi/gashac03@ubuntu/playbooks/roles/sqoop/defaults/main.yml,0,0,2,0,0,0,2
2019-03-09 02:09:41.099839, /home/brokenquark/repo-ansi/gashac03@ubuntu/playbooks/roles/common_vars/defaults/main.yml,11,1,2,0,0,0,14
2019-03-09 02:09:41.107894, /home/brokenquark/repo-ansi/gashac03@ubuntu/playbooks/roles/elasticsearch-monitor/tasks/main.yml,1,0,0,0,0,0,1
2019-03-09 02:09:41.112623, /home/brokenquark/repo-ansi/gashac03@ubuntu/playbooks/roles/devpi/defaults/main.yml,2,0,0,0,0,0,2
2019-03-09 02:09:41.148999, /home/brokenquark/repo-ansi/gashac03@ubuntu/playbooks/roles/user/defaults/main.yml,0,0,0,0,1,0,1
2019-03-09 02:09:41.196648, /home/brokenquark/repo-ansi/gashac03@ubuntu/playbooks/roles/ecommerce/defaults/main.yml,8,0,0,0,0,0,8
2019-03-09 02:09:41.220847, /home/brokenquark/repo-ansi/gashac03@ubuntu/playbooks/roles/newrelic/tasks/main.yml,1,0,0,0,0,0,1
2019-03-09 02:09:41.233601, /home/brokenquark/repo-ansi/gashac03@ubuntu/playbooks/roles/alton/defaults/main.yml,6,0,0,0,0,0,6
2019-03-09 02:09:41.261600, /home/brokenquark/repo-ansi/gashac03@ubuntu/playbooks/roles/xsy/defaults/main.yml,5,0,0,0,0,0,5
2019-03-09 02:09:41.283748, /home/brokenquark/repo-ansi/gashac03@ubuntu/playbooks/roles/gluster/tasks/main.yml,0,0,0,0,1,0,1
2019-03-09 02:09:41.292771, /home/brokenquark/repo-ansi/gashac03@ubuntu/playbooks/roles/certs/defaults/main.yml,4,0,0,0,0,0,4
2019-03-09 02:09:41.318172, /home/brokenquark/repo-ansi/gashac03@ubuntu/playbooks/roles/demo/defaults/main.yml,6,0,0,0,0,0,6
2019-03-09 02:09:41.327374, /home/brokenquark/repo-ansi/gashac03@ubuntu/playbooks/roles/oraclejdk/defaults/main.yml,0,0,1,0,0,0,1
2019-03-09 02:09:41.343368, /home/brokenquark/repo-ansi/gashac03@ubuntu/playbooks/roles/splunkforwarder/defaults/main.yml,0,1,0,0,0,0,1
2019-03-09 02:09:41.351448, /home/brokenquark/repo-ansi/gashac03@ubuntu/playbooks/roles/splunkforwarder/tasks/main.yml,1,0,0,0,0,0,1
2019-03-09 02:09:41.366463, /home/brokenquark/repo-ansi/gashac03@ubuntu/playbooks/roles/notifier/defaults/main.yml,2,2,0,0,0,0,4
2019-03-09 02:09:41.400045, /home/brokenquark/repo-ansi/gashac03@ubuntu/playbooks/roles/edx_ansible/defaults/main.yml,1,0,0,0,0,0,1
2019-03-09 02:09:41.420949, /home/brokenquark/repo-ansi/gashac03@ubuntu/playbooks/roles/snort/defaults/main.yml,0,0,2,0,0,1,3
2019-03-09 02:09:41.437199, /home/brokenquark/repo-ansi/gashac03@ubuntu/playbooks/roles/mariadb/defaults/main.yml,3,0,0,0,0,0,3
2019-03-09 02:09:41.469278, /home/brokenquark/repo-ansi/gashac03@ubuntu/playbooks/roles/minos/meta/main.yml,1,0,0,0,0,0,1
2019-03-09 02:09:41.485457, /home/brokenquark/repo-ansi/gashac03@ubuntu/playbooks/roles/gitreload/defaults/main.yml,1,0,0,0,0,0,1
2019-03-09 02:09:41.505952, /home/brokenquark/repo-ansi/gashac03@ubuntu/playbooks/roles/locust/defaults/main.yml,1,0,0,0,0,0,1
2019-03-09 02:09:41.518534, /home/brokenquark/repo-ansi/gashac03@ubuntu/playbooks/roles/s3fs/defaults/main.yml,0,0,1,0,0,0,1
2019-03-09 02:09:41.529533, /home/brokenquark/repo-ansi/gashac03@ubuntu/playbooks/roles/mongo/defaults/main.yml,7,0,0,0,0,0,7
2019-03-09 02:09:41.562261, /home/brokenquark/repo-ansi/gashac03@ubuntu/playbooks/roles/programs/defaults/main.yml,5,0,0,0,0,0,5
2019-03-09 02:09:41.699957, /home/brokenquark/repo-ansi/gashac03@ubuntu/playbooks/roles/edxapp/defaults/main.yml,17,1,2,0,1,0,21
2019-03-09 02:09:41.758759, /home/brokenquark/repo-ansi/gashac03@ubuntu/playbooks/roles/edxapp/tasks/deploy.yml,0,0,0,0,3,0,3
2019-03-09 02:09:41.818919, /home/brokenquark/repo-ansi/gashac03@ubuntu/playbooks/roles/edx_notes_api/defaults/main.yml,3,0,0,0,0,0,3
2019-03-09 02:09:41.849441, /home/brokenquark/repo-ansi/gashac03@ubuntu/playbooks/roles/rabbitmq/defaults/main.yml,5,0,2,0,0,1,8
2019-03-09 02:09:41.862681, /home/brokenquark/repo-ansi/gashac03@ubuntu/playbooks/roles/rabbitmq/tasks/main.yml,1,0,0,0,1,0,2
2019-03-09 02:09:41.867593, /home/brokenquark/repo-ansi/gashac03@ubuntu/playbooks/roles/analytics_pipeline/defaults/main.yml,2,0,0,0,0,0,2
2019-03-09 02:09:41.902624, /home/brokenquark/repo-ansi/gashac03@ubuntu/playbooks/roles/insights/defaults/main.yml,7,0,1,0,0,0,8
2019-03-09 02:09:41.926178, /home/brokenquark/repo-ansi/gashac03@ubuntu/playbooks/roles/ecomworker/defaults/main.yml,4,0,0,0,0,0,4
2019-03-09 02:09:41.947986, /home/brokenquark/repo-ansi/gashac03@ubuntu/playbooks/roles/supervisor/defaults/main.yml,1,0,0,0,0,0,1
2019-03-09 02:09:41.968091, /home/brokenquark/repo-ansi/gashac03@ubuntu/playbooks/roles/browsers/defaults/main.yml,0,0,1,0,0,1,2
2019-03-09 02:09:41.978413, /home/brokenquark/repo-ansi/gashac03@ubuntu/playbooks/roles/postfix_queue/defaults/main.yml,0,1,0,0,3,0,4
2019-03-09 02:09:41.983199, /home/brokenquark/repo-ansi/gashac03@ubuntu/playbooks/roles/postfix_queue/tasks/main.yml,0,0,0,0,2,0,2
2019-03-09 02:09:41.984282, /home/brokenquark/repo-ansi/gashac03@ubuntu/playbooks/roles/postfix_queue/handlers/main.yml,0,0,0,0,2,0,2
2019-03-09 02:09:41.986408, /home/brokenquark/repo-ansi/gashac03@ubuntu/playbooks/roles/nltk/defaults/main.yml,0,0,3,0,0,3,6
2019-03-09 02:09:42.005995, /home/brokenquark/repo-ansi/gashac03@ubuntu/playbooks/roles/analytics_api/defaults/main.yml,8,0,0,0,0,0,8
2019-03-09 02:09:42.075035, /home/brokenquark/repo-ansi/gashac03@ubuntu/playbooks/roles/mongo_3_0/defaults/main.yml,7,0,0,0,0,0,7
2019-03-09 02:09:42.138379, /home/brokenquark/repo-ansi/gashac03@ubuntu/playbooks/roles/jenkins_worker/defaults/main.yml,1,0,0,0,0,1,2
2019-03-09 02:09:42.146649, /home/brokenquark/repo-ansi/gashac03@ubuntu/playbooks/roles/jenkins_worker/tasks/system.yml,0,0,0,0,2,0,2
2019-03-09 02:09:42.150459, /home/brokenquark/repo-ansi/gashac03@ubuntu/playbooks/roles/jenkins_worker/tasks/test_platform_worker.yml,0,0,0,0,1,0,1
2019-03-09 02:09:42.171316, /home/brokenquark/repo-ansi/gashac03@ubuntu/playbooks/roles/datadog/defaults/main.yml,1,0,0,0,0,0,1
2019-03-09 02:09:42.190243, /home/brokenquark/repo-ansi/gashac03@ubuntu/playbooks/roles/xqueue/defaults/main.yml,5,0,0,0,0,0,5
2019-03-09 02:09:42.221510, /home/brokenquark/repo-ansi/gashac03@ubuntu/playbooks/roles/nginx/defaults/main.yml,2,0,0,0,0,0,2
2019-03-09 02:09:42.241440, /home/brokenquark/repo-ansi/gashac03@ubuntu/playbooks/roles/shibboleth/defaults/main.yml,3,0,1,0,0,0,4
2019-03-09 02:09:42.248497, /home/brokenquark/repo-ansi/gashac03@ubuntu/playbooks/roles/jscover/defaults/main.yml,0,0,1,0,0,0,1
2019-03-09 02:09:42.272626, /home/brokenquark/repo-ansi/gashac03@ubuntu/playbooks/roles/hive/defaults/main.yml,2,0,1,0,0,0,3
2019-03-09 02:09:42.286467, /home/brokenquark/repo-ansi/gashac03@ubuntu/playbooks/roles/local_dev/defaults/main.yml,1,0,0,0,0,0,1
2019-03-09 02:09:42.299116, /home/brokenquark/repo-ansi/gashac03@ubuntu/playbooks/roles/cassandra/defaults/main.yml,1,0,0,0,0,0,1
2019-03-09 02:09:42.307349, /home/brokenquark/repo-ansi/gashac03@ubuntu/playbooks/roles/cassandra/tasks/main.yml,0,0,1,0,0,0,1
2019-03-09 02:09:42.443189, /home/brokenquark/repo-ansi/gashac03@ubuntu/playbooks/edx-east/edx_provision.yml,3,0,0,0,0,0,3
2019-03-09 02:09:42.452429, /home/brokenquark/repo-ansi/gashac03@ubuntu/playbooks/edx-east/add-ubuntu-key.yml,1,0,0,0,0,0,1
2019-03-09 02:09:42.486259, /home/brokenquark/repo-ansi/gashac03@ubuntu/playbooks/edx-east/remove-ubuntu-key.yml,1,0,0,0,0,0,1
2019-03-09 02:09:42.505355, /home/brokenquark/repo-ansi/gashac03@ubuntu/playbooks/edx-east/edx_notifier.yml,5,0,0,0,0,0,5
2019-03-09 02:09:42.561271, /home/brokenquark/repo-ansi/gashac03@ubuntu/playbooks/edx-east/edx_service.yml,1,0,0,0,0,0,1
2019-03-09 02:09:42.609736, /home/brokenquark/repo-ansi/gashac03@ubuntu/playbooks/edx-east/ora2.yml,3,0,0,0,0,0,3
2019-03-09 02:09:42.753555, /home/brokenquark/repo-ansi/gc3-uzh-ch@elasticluster/elasticluster/share/playbooks/roles/common/tasks/ssh_keysign_rhel7.yml,0,0,0,0,2,1,3
2019-03-09 02:09:42.757401, /home/brokenquark/repo-ansi/gc3-uzh-ch@elasticluster/elasticluster/share/playbooks/roles/common/tasks/hostname.yml,0,0,0,0,0,1,1
2019-03-09 02:09:42.765800, /home/brokenquark/repo-ansi/gc3-uzh-ch@elasticluster/elasticluster/share/playbooks/roles/common/tasks/init-RedHat.yml,0,0,0,0,0,1,1
2019-03-09 02:09:42.776182, /home/brokenquark/repo-ansi/gc3-uzh-ch@elasticluster/elasticluster/share/playbooks/roles/common/tasks/hosts.yml,1,0,0,0,0,0,1
2019-03-09 02:09:42.779855, /home/brokenquark/repo-ansi/gc3-uzh-ch@elasticluster/elasticluster/share/playbooks/roles/common/tasks/netgroup.yml,1,0,0,0,0,0,1
2019-03-09 02:09:42.798760, /home/brokenquark/repo-ansi/gc3-uzh-ch@elasticluster/elasticluster/share/playbooks/roles/common/tasks/init-Debian.yml,2,0,0,0,2,0,4
2019-03-09 02:09:42.805298, /home/brokenquark/repo-ansi/gc3-uzh-ch@elasticluster/elasticluster/share/playbooks/roles/common/tasks/ssh_auth.yml,5,0,0,0,0,0,5
2019-03-09 02:09:42.830577, /home/brokenquark/repo-ansi/gc3-uzh-ch@elasticluster/elasticluster/share/playbooks/roles/kubernetes-worker/tasks/main.yml,0,0,0,0,0,1,1
2019-03-09 02:09:42.872599, /home/brokenquark/repo-ansi/gc3-uzh-ch@elasticluster/elasticluster/share/playbooks/roles/nfs-server/tasks/init-Debian.yml,0,0,0,0,1,0,1
2019-03-09 02:09:42.876994, /home/brokenquark/repo-ansi/gc3-uzh-ch@elasticluster/elasticluster/share/playbooks/roles/hdfs-namenode/tasks/main.yml,2,0,0,0,0,0,2
2019-03-09 02:09:42.938700, /home/brokenquark/repo-ansi/gc3-uzh-ch@elasticluster/elasticluster/share/playbooks/roles/slurm-master/tasks/main.yml,1,0,0,0,0,0,1
2019-03-09 02:09:42.946749, /home/brokenquark/repo-ansi/gc3-uzh-ch@elasticluster/elasticluster/share/playbooks/roles/cuda/defaults/main.yml,1,0,0,0,0,0,1
2019-03-09 02:09:42.948480, /home/brokenquark/repo-ansi/gc3-uzh-ch@elasticluster/elasticluster/share/playbooks/roles/cuda/tasks/init-RedHat.yml,1,0,0,0,0,0,1
2019-03-09 02:09:42.951099, /home/brokenquark/repo-ansi/gc3-uzh-ch@elasticluster/elasticluster/share/playbooks/roles/cuda/tasks/_check_nvidia_dev.yml,0,0,0,0,0,1,1
2019-03-09 02:09:42.956222, /home/brokenquark/repo-ansi/gc3-uzh-ch@elasticluster/elasticluster/share/playbooks/roles/cuda/tasks/main.yml,1,0,0,0,0,0,1
2019-03-09 02:09:42.963541, /home/brokenquark/repo-ansi/gc3-uzh-ch@elasticluster/elasticluster/share/playbooks/roles/cuda/tasks/_reboot_and_wait.yml,0,0,0,0,1,0,1
2019-03-09 02:09:42.991370, /home/brokenquark/repo-ansi/gc3-uzh-ch@elasticluster/elasticluster/share/playbooks/roles/gridengine-master/tasks/main.yml,1,0,0,0,0,0,1
2019-03-09 02:09:43.037520, /home/brokenquark/repo-ansi/gc3-uzh-ch@elasticluster/elasticluster/share/playbooks/roles/docker-ce/tasks/init-RedHat.yml,1,0,0,0,0,0,1
2019-03-09 02:09:43.049407, /home/brokenquark/repo-ansi/gc3-uzh-ch@elasticluster/elasticluster/share/playbooks/roles/docker-ce/tasks/init-Debian.yml,1,0,0,0,0,0,1
2019-03-09 02:09:43.061679, /home/brokenquark/repo-ansi/gc3-uzh-ch@elasticluster/elasticluster/share/playbooks/roles/bigtop/defaults/main.yml,0,0,1,0,0,0,1
2019-03-09 02:09:43.068745, /home/brokenquark/repo-ansi/gc3-uzh-ch@elasticluster/elasticluster/share/playbooks/roles/gridengine-common/tasks/init-RedHat.yml,1,0,0,0,0,0,1
2019-03-09 02:09:43.074591, /home/brokenquark/repo-ansi/gc3-uzh-ch@elasticluster/elasticluster/share/playbooks/roles/gridengine-common/tasks/init-Debian.yml,1,0,0,0,0,0,1
2019-03-09 02:09:43.084443, /home/brokenquark/repo-ansi/gc3-uzh-ch@elasticluster/elasticluster/share/playbooks/roles/rstudio/tasks/main.yml,0,0,2,0,0,0,2
2019-03-09 02:09:43.096507, /home/brokenquark/repo-ansi/gc3-uzh-ch@elasticluster/elasticluster/share/playbooks/roles/spark-common/tasks/main.yml,0,0,0,0,0,1,1
2019-03-09 02:09:43.106890, /home/brokenquark/repo-ansi/gc3-uzh-ch@elasticluster/elasticluster/share/playbooks/roles/htcondor/tasks/main.yml,3,0,0,0,1,0,4
2019-03-09 02:09:43.111056, /home/brokenquark/repo-ansi/gc3-uzh-ch@elasticluster/elasticluster/share/playbooks/roles/slurm-common/defaults/main.yml,2,0,0,0,0,0,2
2019-03-09 02:09:43.114505, /home/brokenquark/repo-ansi/gc3-uzh-ch@elasticluster/elasticluster/share/playbooks/roles/slurm-common/tasks/mkdir.yml,0,0,0,0,0,1,1
2019-03-09 02:09:43.128529, /home/brokenquark/repo-ansi/gc3-uzh-ch@elasticluster/elasticluster/share/playbooks/roles/slurm-common/tasks/main.yml,3,0,0,0,0,0,3
2019-03-09 02:09:43.139254, /home/brokenquark/repo-ansi/gc3-uzh-ch@elasticluster/elasticluster/share/playbooks/roles/slurm-common/tasks/munge.yml,0,0,0,0,4,0,4
2019-03-09 02:09:43.160204, /home/brokenquark/repo-ansi/gc3-uzh-ch@elasticluster/elasticluster/share/playbooks/roles/jupyter/tasks/python.yml,0,0,0,0,0,1,1
2019-03-09 02:09:43.166576, /home/brokenquark/repo-ansi/gc3-uzh-ch@elasticluster/elasticluster/share/playbooks/roles/jupyter/tasks/pyspark.yml,0,0,0,0,0,2,2
2019-03-09 02:09:43.189059, /home/brokenquark/repo-ansi/gc3-uzh-ch@elasticluster/elasticluster/share/playbooks/roles/postgresql/vars/RedHat.yml,0,0,0,0,1,0,1
2019-03-09 02:09:43.191577, /home/brokenquark/repo-ansi/gc3-uzh-ch@elasticluster/elasticluster/share/playbooks/roles/postgresql/tests/playbook.yml,1,0,0,0,0,0,1
2019-03-09 02:09:43.194083, /home/brokenquark/repo-ansi/gc3-uzh-ch@elasticluster/elasticluster/share/playbooks/roles/postgresql/tests/vars.yml,3,0,0,0,0,0,3
2019-03-09 02:09:43.245282, /home/brokenquark/repo-ansi/gc3-uzh-ch@elasticluster/elasticluster/share/playbooks/roles/postgresql/defaults/main.yml,5,1,1,0,15,0,22
2019-03-09 02:09:43.280483, /home/brokenquark/repo-ansi/gc3-uzh-ch@elasticluster/elasticluster/share/playbooks/roles/postgresql/tasks/configure.yml,0,0,0,0,0,1,1
2019-03-09 02:09:43.327568, /home/brokenquark/repo-ansi/gc3-uzh-ch@elasticluster/elasticluster/share/playbooks/roles/glusterfs-server/defaults/main.yml,0,0,0,0,1,0,1
2019-03-09 02:09:43.358854, /home/brokenquark/repo-ansi/gc3-uzh-ch@elasticluster/elasticluster/share/playbooks/roles/ganglia-web/tasks/main.yml,0,0,0,0,0,2,2
2019-03-09 02:09:43.365398, /home/brokenquark/repo-ansi/gc3-uzh-ch@elasticluster/elasticluster/share/playbooks/roles/anaconda/defaults/main.yml,0,0,1,0,0,0,1
2019-03-09 02:09:43.368959, /home/brokenquark/repo-ansi/gc3-uzh-ch@elasticluster/elasticluster/share/playbooks/roles/anaconda/tasks/main.yml,1,0,0,0,0,0,1
2019-03-09 02:09:43.376124, /home/brokenquark/repo-ansi/gc3-uzh-ch@elasticluster/elasticluster/share/playbooks/roles/glusterfs-common/tasks/debian.yml,2,0,0,0,0,0,2
2019-03-09 02:09:43.384077, /home/brokenquark/repo-ansi/gc3-uzh-ch@elasticluster/elasticluster/share/playbooks/roles/ceph/defaults/main.yml,1,0,0,0,0,0,1
2019-03-09 02:09:43.397231, /home/brokenquark/repo-ansi/gc3-uzh-ch@elasticluster/elasticluster/share/playbooks/roles/ceph/tasks/_keyring.yml,0,0,0,0,1,0,1
2019-03-09 02:09:43.404505, /home/brokenquark/repo-ansi/gc3-uzh-ch@elasticluster/elasticluster/share/playbooks/roles/ceph/tasks/mon.yml,3,0,0,0,0,0,3
2019-03-09 02:09:43.426463, /home/brokenquark/repo-ansi/gc3-uzh-ch@elasticluster/elasticluster/share/playbooks/roles/ceph/tasks/main.yml,2,0,0,0,0,0,2
2019-03-09 02:09:43.444246, /home/brokenquark/repo-ansi/gc3-uzh-ch@elasticluster/elasticluster/share/playbooks/roles/ceph/tasks/mgr.yml,3,0,0,0,0,0,3
2019-03-09 02:09:43.453866, /home/brokenquark/repo-ansi/gc3-uzh-ch@elasticluster/elasticluster/share/playbooks/roles/ceph/tasks/mds.yml,3,0,0,0,0,1,4
2019-03-09 02:09:43.458761, /home/brokenquark/repo-ansi/gc3-uzh-ch@elasticluster/elasticluster/share/playbooks/roles/ceph/tasks/client.yml,2,0,0,0,0,0,2
2019-03-09 02:09:43.469132, /home/brokenquark/repo-ansi/gc3-uzh-ch@elasticluster/elasticluster/share/playbooks/roles/ceph/tasks/osd.yml,2,0,0,0,0,0,2
2019-03-09 02:09:43.483060, /home/brokenquark/repo-ansi/gc3-uzh-ch@elasticluster/elasticluster/share/playbooks/roles/pbspro/tasks/worker.yml,1,0,0,0,0,0,1
2019-03-09 02:09:43.490237, /home/brokenquark/repo-ansi/gc3-uzh-ch@elasticluster/elasticluster/share/playbooks/roles/pbspro/tasks/master.yml,2,0,0,0,0,0,2
2019-03-09 02:09:43.492630, /home/brokenquark/repo-ansi/gc3-uzh-ch@elasticluster/elasticluster/share/playbooks/roles/pbspro/tasks/client.yml,1,0,0,0,0,0,1
2019-03-09 02:09:43.506025, /home/brokenquark/repo-ansi/gc3-uzh-ch@elasticluster/elasticluster/share/playbooks/roles/jupyterhub/tasks/main.yml,0,0,0,0,0,1,1
2019-03-09 02:09:43.537849, /home/brokenquark/repo-ansi/gc3-uzh-ch@elasticluster/elasticluster/share/playbooks/roles/easybuild/tasks/main.yml,1,0,0,0,0,0,1
2019-03-09 02:09:43.574133, /home/brokenquark/repo-ansi/gc3-uzh-ch@elasticluster/elasticluster/share/playbooks/roles/kubernetes-common/tasks/redhat.yml,2,0,1,0,0,0,3
2019-03-09 02:09:43.575415, /home/brokenquark/repo-ansi/gc3-uzh-ch@elasticluster/elasticluster/share/playbooks/roles/autofs/tasks/init-RedHat.yml,1,0,0,0,0,0,1
2019-03-09 02:09:43.580946, /home/brokenquark/repo-ansi/gc3-uzh-ch@elasticluster/elasticluster/share/playbooks/roles/autofs/tasks/main.yml,2,0,0,0,0,0,2
2019-03-09 02:09:43.582798, /home/brokenquark/repo-ansi/gc3-uzh-ch@elasticluster/elasticluster/share/playbooks/roles/autofs/tasks/init-Debian.yml,1,0,0,0,0,0,1
2019-03-09 02:09:43.585970, /home/brokenquark/repo-ansi/gc3-uzh-ch@elasticluster/elasticluster/share/playbooks/roles/autofs/tasks/gcs.yml,1,0,0,0,0,0,1
2019-03-09 02:09:43.594833, /home/brokenquark/repo-ansi/gc3-uzh-ch@elasticluster/elasticluster/share/playbooks/roles/torque/tasks/maui.yml,0,0,1,0,0,0,1
2019-03-09 02:09:43.610238, /home/brokenquark/repo-ansi/gc3-uzh-ch@elasticluster/elasticluster/share/playbooks/roles/torque/tasks/master.yml,1,0,0,0,0,0,1
2019-03-09 02:09:43.621810, /home/brokenquark/repo-ansi/gc3-uzh-ch@elasticluster/elasticluster/share/playbooks/roles/smb-server/tasks/main.yml,3,0,0,0,0,0,3
2019-03-09 02:09:43.631445, /home/brokenquark/repo-ansi/gc3-uzh-ch@elasticluster/elasticluster/share/playbooks/roles/smb-server/tasks/ctdb.yml,2,0,0,0,0,0,2
2019-03-09 02:09:43.645456, /home/brokenquark/repo-ansi/gc3-uzh-ch@elasticluster/elasticluster/share/playbooks/roles/slurm-worker/tasks/cgroup.yml,5,0,0,0,0,1,6
2019-03-09 02:09:43.652242, /home/brokenquark/repo-ansi/gc3-uzh-ch@elasticluster/elasticluster/share/playbooks/roles/slurm-worker/tasks/main.yml,1,0,0,0,0,0,1
2019-03-09 02:09:43.676744, /home/brokenquark/repo-ansi/gc3-uzh-ch@elasticluster/elasticluster/share/playbooks/roles/iptables/tasks/main.yml,3,0,0,0,0,0,3
2019-03-09 02:09:43.695441, /home/brokenquark/repo-ansi/gc3-uzh-ch@elasticluster/elasticluster/share/playbooks/roles/hive/defaults/main.yml,2,0,0,0,0,0,2
2019-03-09 02:09:43.703274, /home/brokenquark/repo-ansi/gc3-uzh-ch@elasticluster/elasticluster/share/playbooks/roles/lmod/defaults/main.yml,2,0,0,0,0,0,2
2019-03-09 02:09:43.714283, /home/brokenquark/repo-ansi/gc3-uzh-ch@elasticluster/elasticluster/share/playbooks/roles/lmod/tasks/build.yml,0,0,0,0,1,0,1
2019-03-09 02:09:43.730697, /home/brokenquark/repo-ansi/gc3-uzh-ch@elasticluster/elasticluster/share/playbooks/roles/r/defaults/main.yml,0,0,1,0,0,0,1
2019-03-09 02:09:43.750266, /home/brokenquark/repo-ansi/gc3-uzh-ch@elasticluster/elasticluster/share/playbooks/roles/r/tasks/init-Debian.yml,2,0,0,0,0,0,2
2019-03-09 02:09:45.603516, /home/brokenquark/repo-ansi/girder@girder_worker/devops/ansible/examples/girder-worker-single-vm/playbooks/site.yml,5,0,0,0,0,0,5
2019-03-09 02:09:45.611013, /home/brokenquark/repo-ansi/girder@girder_worker/devops/ansible/examples/girder-worker-single-vm/playbooks/post-tasks/girder.yml,12,0,0,0,0,0,12
2019-03-09 02:09:45.614547, /home/brokenquark/repo-ansi/girder@girder_worker/devops/ansible/examples/girder-worker-single-vm/playbooks/post-tasks/worker.yml,1,0,0,0,0,0,1
2019-03-09 02:09:45.621382, /home/brokenquark/repo-ansi/girder@girder_worker/devops/ansible/examples/girder-worker-multi-vm/playbooks/database/site.yml,4,0,0,2,0,1,7
2019-03-09 02:09:45.637106, /home/brokenquark/repo-ansi/girder@girder_worker/devops/ansible/examples/girder-worker-multi-vm/playbooks/app/site.yml,16,0,0,0,0,1,17
2019-03-09 02:09:45.645626, /home/brokenquark/repo-ansi/girder@girder_worker/devops/ansible/examples/girder-worker-multi-vm/playbooks/worker/site.yml,5,0,0,0,0,1,6
2019-03-09 02:09:45.652069, /home/brokenquark/repo-ansi/girder@girder_worker/devops/ansible/examples/girder-worker-multi-vm/playbooks/queue/site.yml,7,0,0,0,0,1,8
2019-03-09 02:09:45.904731, /home/brokenquark/repo-ansi/gluster@gdeploy/playbooks/set-pcs-auth-passwd.yml,1,0,0,0,0,0,1
2019-03-09 02:09:45.978550, /home/brokenquark/repo-ansi/gluster@gdeploy/playbooks/ssl-vol-set.yml,3,0,0,0,0,0,3
2019-03-09 02:09:46.042692, /home/brokenquark/repo-ansi/gluster@gdeploy/playbooks/define_service_ports.yml,0,0,0,0,1,0,1
2019-03-09 02:09:46.087068, /home/brokenquark/repo-ansi/gluster@gdeploy/playbooks/ganesha-bootstrap-new-nodes.yml,1,0,0,0,0,0,1
2019-03-09 02:09:57.528734, /home/brokenquark/repo-ansi/hastexo@edx-configuration-old/playbooks/roles/jenkins_master/defaults/main.yml,1,0,1,0,0,0,2
2019-03-09 02:09:57.540563, /home/brokenquark/repo-ansi/hastexo@edx-configuration-old/playbooks/roles/jenkins_master/tasks/main.yml,0,0,1,0,3,0,4
2019-03-09 02:09:57.556182, /home/brokenquark/repo-ansi/hastexo@edx-configuration-old/playbooks/roles/common/defaults/main.yml,11,1,2,0,0,0,14
2019-03-09 02:09:57.565780, /home/brokenquark/repo-ansi/hastexo@edx-configuration-old/playbooks/roles/common/tasks/main.yml,0,0,0,0,1,0,1
2019-03-09 02:09:57.582094, /home/brokenquark/repo-ansi/hastexo@edx-configuration-old/playbooks/roles/harprofiler/defaults/main.yml,1,0,0,0,0,0,1
2019-03-09 02:09:57.620510, /home/brokenquark/repo-ansi/hastexo@edx-configuration-old/playbooks/roles/edx_service_rds/defaults/main.yml,2,0,0,4,0,0,6
2019-03-09 02:09:57.656538, /home/brokenquark/repo-ansi/hastexo@edx-configuration-old/playbooks/roles/newrelic-npi/defaults/main.yml,1,0,0,0,0,0,1
2019-03-09 02:09:57.669676, /home/brokenquark/repo-ansi/hastexo@edx-configuration-old/playbooks/roles/xserver/defaults/main.yml,2,0,0,0,0,0,2
2019-03-09 02:09:57.693000, /home/brokenquark/repo-ansi/hastexo@edx-configuration-old/playbooks/roles/test_build_server/defaults/main.yml,1,0,0,0,0,0,1
2019-03-09 02:09:57.701956, /home/brokenquark/repo-ansi/hastexo@edx-configuration-old/playbooks/roles/aws/defaults/main.yml,3,0,1,0,1,1,6
2019-03-09 02:09:57.712478, /home/brokenquark/repo-ansi/hastexo@edx-configuration-old/playbooks/roles/aws/tasks/main.yml,1,0,0,0,2,0,3
2019-03-09 02:09:57.721725, /home/brokenquark/repo-ansi/hastexo@edx-configuration-old/playbooks/roles/forum/defaults/main.yml,3,0,0,1,0,0,4
2019-03-09 02:09:57.746383, /home/brokenquark/repo-ansi/hastexo@edx-configuration-old/playbooks/roles/hadoop_common/defaults/main.yml,1,0,0,0,0,0,1
2019-03-09 02:09:57.761320, /home/brokenquark/repo-ansi/hastexo@edx-configuration-old/playbooks/roles/hadoop_common/tasks/main.yml,1,0,0,0,0,0,1
2019-03-09 02:09:57.780961, /home/brokenquark/repo-ansi/hastexo@edx-configuration-old/playbooks/roles/ora/defaults/main.yml,7,0,0,0,0,0,7
2019-03-09 02:09:57.807133, /home/brokenquark/repo-ansi/hastexo@edx-configuration-old/playbooks/roles/ecommerce_worker/defaults/main.yml,4,0,0,0,0,0,4
2019-03-09 02:09:57.819046, /home/brokenquark/repo-ansi/hastexo@edx-configuration-old/playbooks/roles/redis/defaults/main.yml,1,1,0,0,0,0,2
2019-03-09 02:09:57.824618, /home/brokenquark/repo-ansi/hastexo@edx-configuration-old/playbooks/roles/elasticsearch/defaults/main.yml,1,0,0,0,0,0,1
2019-03-09 02:09:57.837090, /home/brokenquark/repo-ansi/hastexo@edx-configuration-old/playbooks/roles/antivirus/defaults/main.yml,1,0,0,0,0,0,1
2019-03-09 02:09:57.856360, /home/brokenquark/repo-ansi/hastexo@edx-configuration-old/playbooks/roles/flower/defaults/main.yml,4,0,0,1,0,0,5
2019-03-09 02:09:57.866649, /home/brokenquark/repo-ansi/hastexo@edx-configuration-old/playbooks/roles/gh_mirror/defaults/main.yml,1,0,0,0,0,0,1
2019-03-09 02:09:57.875367, /home/brokenquark/repo-ansi/hastexo@edx-configuration-old/playbooks/roles/sqoop/defaults/main.yml,0,0,2,0,0,0,2
2019-03-09 02:09:57.888651, /home/brokenquark/repo-ansi/hastexo@edx-configuration-old/playbooks/roles/elasticsearch-monitor/tasks/main.yml,1,0,0,0,0,0,1
2019-03-09 02:09:57.892843, /home/brokenquark/repo-ansi/hastexo@edx-configuration-old/playbooks/roles/devpi/defaults/main.yml,2,0,0,0,0,0,2
2019-03-09 02:09:57.926323, /home/brokenquark/repo-ansi/hastexo@edx-configuration-old/playbooks/roles/user/defaults/main.yml,0,0,0,0,1,0,1
2019-03-09 02:09:57.959618, /home/brokenquark/repo-ansi/hastexo@edx-configuration-old/playbooks/roles/ecommerce/defaults/main.yml,8,0,0,0,0,0,8
2019-03-09 02:09:57.979559, /home/brokenquark/repo-ansi/hastexo@edx-configuration-old/playbooks/roles/newrelic/tasks/newrelic-logwatcher.yml,1,0,0,0,0,0,1
2019-03-09 02:09:57.993905, /home/brokenquark/repo-ansi/hastexo@edx-configuration-old/playbooks/roles/newrelic/meta/main.yml,2,0,0,0,0,0,2
2019-03-09 02:09:58.001915, /home/brokenquark/repo-ansi/hastexo@edx-configuration-old/playbooks/roles/alton/defaults/main.yml,6,0,0,0,0,0,6
2019-03-09 02:09:58.031759, /home/brokenquark/repo-ansi/hastexo@edx-configuration-old/playbooks/roles/gluster/tasks/main.yml,0,0,0,0,1,0,1
2019-03-09 02:09:58.040762, /home/brokenquark/repo-ansi/hastexo@edx-configuration-old/playbooks/roles/certs/defaults/main.yml,4,0,0,0,0,0,4
2019-03-09 02:09:58.062768, /home/brokenquark/repo-ansi/hastexo@edx-configuration-old/playbooks/roles/demo/defaults/main.yml,6,0,0,0,0,0,6
2019-03-09 02:09:58.070691, /home/brokenquark/repo-ansi/hastexo@edx-configuration-old/playbooks/roles/oraclejdk/defaults/main.yml,0,0,1,0,0,0,1
2019-03-09 02:09:58.079104, /home/brokenquark/repo-ansi/hastexo@edx-configuration-old/playbooks/roles/splunkforwarder/defaults/main.yml,0,1,0,0,0,0,1
2019-03-09 02:09:58.086919, /home/brokenquark/repo-ansi/hastexo@edx-configuration-old/playbooks/roles/splunkforwarder/tasks/main.yml,1,0,0,0,0,0,1
2019-03-09 02:09:58.100094, /home/brokenquark/repo-ansi/hastexo@edx-configuration-old/playbooks/roles/notifier/defaults/main.yml,2,2,0,0,0,0,4
2019-03-09 02:09:58.124938, /home/brokenquark/repo-ansi/hastexo@edx-configuration-old/playbooks/roles/edx_ansible/defaults/main.yml,1,0,0,0,0,0,1
2019-03-09 02:09:58.144285, /home/brokenquark/repo-ansi/hastexo@edx-configuration-old/playbooks/roles/snort/defaults/main.yml,0,0,2,0,0,1,3
2019-03-09 02:09:58.159948, /home/brokenquark/repo-ansi/hastexo@edx-configuration-old/playbooks/roles/mariadb/defaults/main.yml,3,0,0,0,0,0,3
2019-03-09 02:09:58.189941, /home/brokenquark/repo-ansi/hastexo@edx-configuration-old/playbooks/roles/minos/meta/main.yml,1,0,0,0,0,0,1
2019-03-09 02:09:58.204544, /home/brokenquark/repo-ansi/hastexo@edx-configuration-old/playbooks/roles/gitreload/defaults/main.yml,1,0,0,0,0,0,1
2019-03-09 02:09:58.223068, /home/brokenquark/repo-ansi/hastexo@edx-configuration-old/playbooks/roles/locust/defaults/main.yml,1,0,0,0,0,0,1
2019-03-09 02:09:58.234157, /home/brokenquark/repo-ansi/hastexo@edx-configuration-old/playbooks/roles/s3fs/defaults/main.yml,0,0,1,0,0,0,1
2019-03-09 02:09:58.244544, /home/brokenquark/repo-ansi/hastexo@edx-configuration-old/playbooks/roles/mongo/defaults/main.yml,7,0,1,0,0,0,8
2019-03-09 02:09:58.268906, /home/brokenquark/repo-ansi/hastexo@edx-configuration-old/playbooks/roles/programs/defaults/main.yml,5,0,0,0,0,0,5
2019-03-09 02:09:58.393460, /home/brokenquark/repo-ansi/hastexo@edx-configuration-old/playbooks/roles/edxapp/defaults/main.yml,17,1,2,0,1,0,21
2019-03-09 02:09:58.442873, /home/brokenquark/repo-ansi/hastexo@edx-configuration-old/playbooks/roles/edxapp/tasks/deploy.yml,0,0,0,0,3,0,3
2019-03-09 02:09:58.474665, /home/brokenquark/repo-ansi/hastexo@edx-configuration-old/playbooks/roles/edx_notes_api/defaults/main.yml,3,0,0,0,0,0,3
2019-03-09 02:09:58.503221, /home/brokenquark/repo-ansi/hastexo@edx-configuration-old/playbooks/roles/rabbitmq/defaults/main.yml,5,0,2,0,0,1,8
2019-03-09 02:09:58.515639, /home/brokenquark/repo-ansi/hastexo@edx-configuration-old/playbooks/roles/rabbitmq/tasks/main.yml,1,0,0,0,1,0,2
2019-03-09 02:09:58.519717, /home/brokenquark/repo-ansi/hastexo@edx-configuration-old/playbooks/roles/analytics_pipeline/defaults/main.yml,2,0,0,0,0,0,2
2019-03-09 02:09:58.547367, /home/brokenquark/repo-ansi/hastexo@edx-configuration-old/playbooks/roles/insights/defaults/main.yml,7,0,1,0,0,0,8
2019-03-09 02:09:58.566487, /home/brokenquark/repo-ansi/hastexo@edx-configuration-old/playbooks/roles/supervisor/defaults/main.yml,1,0,0,0,0,0,1
2019-03-09 02:09:58.580841, /home/brokenquark/repo-ansi/hastexo@edx-configuration-old/playbooks/roles/browsers/defaults/main.yml,0,0,1,0,0,1,2
2019-03-09 02:09:58.590639, /home/brokenquark/repo-ansi/hastexo@edx-configuration-old/playbooks/roles/nltk/defaults/main.yml,0,0,3,0,0,3,6
2019-03-09 02:09:58.617144, /home/brokenquark/repo-ansi/hastexo@edx-configuration-old/playbooks/roles/analytics_api/defaults/main.yml,8,0,0,0,0,0,8
2019-03-09 02:09:58.678300, /home/brokenquark/repo-ansi/hastexo@edx-configuration-old/playbooks/roles/mongo_3_0/defaults/main.yml,7,0,0,0,0,0,7
2019-03-09 02:09:58.730364, /home/brokenquark/repo-ansi/hastexo@edx-configuration-old/playbooks/roles/jenkins_worker/defaults/main.yml,1,0,0,0,0,1,2
2019-03-09 02:09:58.738948, /home/brokenquark/repo-ansi/hastexo@edx-configuration-old/playbooks/roles/jenkins_worker/tasks/system.yml,0,0,0,0,2,0,2
2019-03-09 02:09:58.761238, /home/brokenquark/repo-ansi/hastexo@edx-configuration-old/playbooks/roles/datadog/defaults/main.yml,1,0,0,0,0,0,1
2019-03-09 02:09:58.777615, /home/brokenquark/repo-ansi/hastexo@edx-configuration-old/playbooks/roles/xqueue/defaults/main.yml,5,0,0,0,0,0,5
2019-03-09 02:09:58.803390, /home/brokenquark/repo-ansi/hastexo@edx-configuration-old/playbooks/roles/nginx/defaults/main.yml,2,0,0,0,0,0,2
2019-03-09 02:09:58.821740, /home/brokenquark/repo-ansi/hastexo@edx-configuration-old/playbooks/roles/shibboleth/defaults/main.yml,3,0,1,0,0,0,4
2019-03-09 02:09:58.827653, /home/brokenquark/repo-ansi/hastexo@edx-configuration-old/playbooks/roles/jscover/defaults/main.yml,0,0,1,0,0,0,1
2019-03-09 02:09:58.847066, /home/brokenquark/repo-ansi/hastexo@edx-configuration-old/playbooks/roles/hive/defaults/main.yml,2,0,1,0,0,0,3
2019-03-09 02:09:58.860377, /home/brokenquark/repo-ansi/hastexo@edx-configuration-old/playbooks/roles/local_dev/defaults/main.yml,1,0,0,0,0,0,1
2019-03-09 02:09:58.870321, /home/brokenquark/repo-ansi/hastexo@edx-configuration-old/playbooks/roles/cassandra/defaults/main.yml,1,0,0,0,0,0,1
2019-03-09 02:09:58.878173, /home/brokenquark/repo-ansi/hastexo@edx-configuration-old/playbooks/roles/cassandra/tasks/main.yml,0,0,1,0,0,0,1
2019-03-09 02:09:58.899720, /home/brokenquark/repo-ansi/hastexo@edx-configuration-old/playbooks/edx-west/stage-worker.yml,1,0,0,0,0,0,1
2019-03-09 02:09:58.944147, /home/brokenquark/repo-ansi/hastexo@edx-configuration-old/playbooks/edx-west/stage-notifier-only.yml,1,0,0,0,0,0,1
2019-03-09 02:09:59.046896, /home/brokenquark/repo-ansi/hastexo@edx-configuration-old/playbooks/edx-east/edx_provision.yml,3,0,0,0,0,0,3
2019-03-09 02:09:59.055158, /home/brokenquark/repo-ansi/hastexo@edx-configuration-old/playbooks/edx-east/add-ubuntu-key.yml,1,0,0,0,0,0,1
2019-03-09 02:09:59.085052, /home/brokenquark/repo-ansi/hastexo@edx-configuration-old/playbooks/edx-east/remove-ubuntu-key.yml,1,0,0,0,0,0,1
2019-03-09 02:09:59.104107, /home/brokenquark/repo-ansi/hastexo@edx-configuration-old/playbooks/edx-east/edx_notifier.yml,5,0,0,0,0,0,5
2019-03-09 02:09:59.151222, /home/brokenquark/repo-ansi/hastexo@edx-configuration-old/playbooks/edx-east/edx_service.yml,1,0,0,0,0,0,1
2019-03-09 02:09:59.180695, /home/brokenquark/repo-ansi/hastexo@edx-configuration-old/playbooks/edx-east/ora2.yml,3,0,0,0,0,0,3
2019-03-09 02:10:03.879133, /home/brokenquark/repo-ansi/hmcmooc@ec2-edx-configuration/playbooks/roles/jenkins_master/defaults/main.yml,1,0,1,0,0,0,2
2019-03-09 02:10:03.892599, /home/brokenquark/repo-ansi/hmcmooc@ec2-edx-configuration/playbooks/roles/jenkins_master/tasks/main.yml,0,0,0,0,4,0,4
2019-03-09 02:10:03.902953, /home/brokenquark/repo-ansi/hmcmooc@ec2-edx-configuration/playbooks/roles/common/defaults/main.yml,11,1,1,0,0,0,13
2019-03-09 02:10:03.913468, /home/brokenquark/repo-ansi/hmcmooc@ec2-edx-configuration/playbooks/roles/common/tasks/main.yml,0,0,0,0,1,0,1
2019-03-09 02:10:03.930585, /home/brokenquark/repo-ansi/hmcmooc@ec2-edx-configuration/playbooks/roles/gerrit/defaults/main.yml,1,0,0,0,0,0,1
2019-03-09 02:10:03.950219, /home/brokenquark/repo-ansi/hmcmooc@ec2-edx-configuration/playbooks/roles/xserver/defaults/main.yml,3,0,0,0,0,0,3
2019-03-09 02:10:03.968803, /home/brokenquark/repo-ansi/hmcmooc@ec2-edx-configuration/playbooks/roles/test_build_server/defaults/main.yml,1,0,0,0,0,0,1
2019-03-09 02:10:03.975274, /home/brokenquark/repo-ansi/hmcmooc@ec2-edx-configuration/playbooks/roles/aws/defaults/main.yml,0,0,1,0,1,1,3
2019-03-09 02:10:03.983487, /home/brokenquark/repo-ansi/hmcmooc@ec2-edx-configuration/playbooks/roles/aws/tasks/main.yml,1,0,0,0,0,0,1
2019-03-09 02:10:03.992216, /home/brokenquark/repo-ansi/hmcmooc@ec2-edx-configuration/playbooks/roles/forum/defaults/main.yml,3,0,0,1,0,0,4
2019-03-09 02:10:04.021869, /home/brokenquark/repo-ansi/hmcmooc@ec2-edx-configuration/playbooks/roles/analytics-api/defaults/main.yml,7,1,0,0,0,0,8
2019-03-09 02:10:04.054419, /home/brokenquark/repo-ansi/hmcmooc@ec2-edx-configuration/playbooks/roles/ora/defaults/main.yml,13,0,0,0,0,0,13
2019-03-09 02:10:04.077206, /home/brokenquark/repo-ansi/hmcmooc@ec2-edx-configuration/playbooks/roles/redis/defaults/main.yml,1,1,0,0,0,0,2
2019-03-09 02:10:04.082712, /home/brokenquark/repo-ansi/hmcmooc@ec2-edx-configuration/playbooks/roles/elasticsearch/defaults/main.yml,1,0,0,0,0,0,1
2019-03-09 02:10:04.101543, /home/brokenquark/repo-ansi/hmcmooc@ec2-edx-configuration/playbooks/roles/flower/defaults/main.yml,3,0,0,1,0,0,4
2019-03-09 02:10:04.110654, /home/brokenquark/repo-ansi/hmcmooc@ec2-edx-configuration/playbooks/roles/gh_mirror/defaults/main.yml,1,0,0,0,0,0,1
2019-03-09 02:10:04.124232, /home/brokenquark/repo-ansi/hmcmooc@ec2-edx-configuration/playbooks/roles/analytics/defaults/main.yml,8,0,0,0,0,0,8
2019-03-09 02:10:04.143825, /home/brokenquark/repo-ansi/hmcmooc@ec2-edx-configuration/playbooks/roles/devpi/defaults/main.yml,2,0,0,0,0,0,2
2019-03-09 02:10:04.169750, /home/brokenquark/repo-ansi/hmcmooc@ec2-edx-configuration/playbooks/roles/user/defaults/main.yml,0,0,0,0,1,0,1
2019-03-09 02:10:04.195146, /home/brokenquark/repo-ansi/hmcmooc@ec2-edx-configuration/playbooks/roles/alton/defaults/main.yml,4,0,0,0,0,0,4
2019-03-09 02:10:04.227906, /home/brokenquark/repo-ansi/hmcmooc@ec2-edx-configuration/playbooks/roles/gluster/tasks/main.yml,0,0,0,0,1,0,1
2019-03-09 02:10:04.240987, /home/brokenquark/repo-ansi/hmcmooc@ec2-edx-configuration/playbooks/roles/certs/defaults/main.yml,10,0,0,0,0,0,10
2019-03-09 02:10:04.263154, /home/brokenquark/repo-ansi/hmcmooc@ec2-edx-configuration/playbooks/roles/demo/defaults/main.yml,5,0,0,0,0,0,5
2019-03-09 02:10:04.270552, /home/brokenquark/repo-ansi/hmcmooc@ec2-edx-configuration/playbooks/roles/oraclejdk/defaults/main.yml,0,0,1,0,0,0,1
2019-03-09 02:10:04.279332, /home/brokenquark/repo-ansi/hmcmooc@ec2-edx-configuration/playbooks/roles/splunkforwarder/defaults/main.yml,0,1,0,0,0,0,1
2019-03-09 02:10:04.287096, /home/brokenquark/repo-ansi/hmcmooc@ec2-edx-configuration/playbooks/roles/splunkforwarder/tasks/main.yml,1,0,0,0,0,0,1
2019-03-09 02:10:04.298715, /home/brokenquark/repo-ansi/hmcmooc@ec2-edx-configuration/playbooks/roles/notifier/defaults/main.yml,2,2,0,0,0,0,4
2019-03-09 02:10:04.317054, /home/brokenquark/repo-ansi/hmcmooc@ec2-edx-configuration/playbooks/roles/edx_ansible/defaults/main.yml,1,0,0,0,0,0,1
2019-03-09 02:10:04.333725, /home/brokenquark/repo-ansi/hmcmooc@ec2-edx-configuration/playbooks/roles/snort/defaults/main.yml,0,0,2,0,0,1,3
2019-03-09 02:10:04.374525, /home/brokenquark/repo-ansi/hmcmooc@ec2-edx-configuration/playbooks/roles/s3fs/defaults/main.yml,0,0,1,0,0,0,1
2019-03-09 02:10:04.382699, /home/brokenquark/repo-ansi/hmcmooc@ec2-edx-configuration/playbooks/roles/mongo/defaults/main.yml,5,0,1,0,0,0,6
2019-03-09 02:10:04.468081, /home/brokenquark/repo-ansi/hmcmooc@ec2-edx-configuration/playbooks/roles/edxapp/defaults/main.yml,91,2,4,0,1,0,98
2019-03-09 02:10:04.524245, /home/brokenquark/repo-ansi/hmcmooc@ec2-edx-configuration/playbooks/roles/edxapp/tasks/deploy.yml,0,0,0,0,3,0,3
2019-03-09 02:10:04.562805, /home/brokenquark/repo-ansi/hmcmooc@ec2-edx-configuration/playbooks/roles/rabbitmq/defaults/main.yml,5,0,2,0,0,1,8
2019-03-09 02:10:04.575150, /home/brokenquark/repo-ansi/hmcmooc@ec2-edx-configuration/playbooks/roles/rabbitmq/tasks/main.yml,1,0,0,0,1,0,2
2019-03-09 02:10:04.583583, /home/brokenquark/repo-ansi/hmcmooc@ec2-edx-configuration/playbooks/roles/analytics-server/defaults/main.yml,8,0,0,0,0,0,8
2019-03-09 02:10:04.605068, /home/brokenquark/repo-ansi/hmcmooc@ec2-edx-configuration/playbooks/roles/supervisor/defaults/main.yml,1,0,0,0,0,0,1
2019-03-09 02:10:04.618955, /home/brokenquark/repo-ansi/hmcmooc@ec2-edx-configuration/playbooks/roles/browsers/defaults/main.yml,0,0,1,0,0,1,2
2019-03-09 02:10:04.624683, /home/brokenquark/repo-ansi/hmcmooc@ec2-edx-configuration/playbooks/roles/nltk/defaults/main.yml,0,0,3,0,0,3,6
2019-03-09 02:10:04.638697, /home/brokenquark/repo-ansi/hmcmooc@ec2-edx-configuration/playbooks/roles/discern/defaults/main.yml,5,0,1,0,0,1,7
2019-03-09 02:10:04.656254, /home/brokenquark/repo-ansi/hmcmooc@ec2-edx-configuration/playbooks/roles/discern/tasks/main.yml,0,0,0,0,1,0,1
2019-03-09 02:10:04.714027, /home/brokenquark/repo-ansi/hmcmooc@ec2-edx-configuration/playbooks/roles/xqwatcher/defaults/main.yml,5,0,0,0,0,0,5
2019-03-09 02:10:04.739950, /home/brokenquark/repo-ansi/hmcmooc@ec2-edx-configuration/playbooks/roles/jenkins_worker/defaults/main.yml,1,0,1,0,0,2,4
2019-03-09 02:10:04.750520, /home/brokenquark/repo-ansi/hmcmooc@ec2-edx-configuration/playbooks/roles/jenkins_worker/tasks/system.yml,0,0,0,0,2,0,2
2019-03-09 02:10:04.765402, /home/brokenquark/repo-ansi/hmcmooc@ec2-edx-configuration/playbooks/roles/datadog/defaults/main.yml,1,0,1,0,0,0,2
2019-03-09 02:10:04.780740, /home/brokenquark/repo-ansi/hmcmooc@ec2-edx-configuration/playbooks/roles/xqueue/defaults/main.yml,9,0,0,0,0,0,9
2019-03-09 02:10:04.804655, /home/brokenquark/repo-ansi/hmcmooc@ec2-edx-configuration/playbooks/roles/nginx/defaults/main.yml,2,0,0,0,0,0,2
2019-03-09 02:10:04.822566, /home/brokenquark/repo-ansi/hmcmooc@ec2-edx-configuration/playbooks/roles/shibboleth/defaults/main.yml,3,0,1,0,0,0,4
2019-03-09 02:10:04.838258, /home/brokenquark/repo-ansi/hmcmooc@ec2-edx-configuration/playbooks/roles/local_dev/defaults/main.yml,1,0,0,0,0,0,1
2019-03-09 02:10:04.861491, /home/brokenquark/repo-ansi/hmcmooc@ec2-edx-configuration/playbooks/edx-west/stage-worker.yml,1,0,0,0,0,0,1
2019-03-09 02:10:04.911215, /home/brokenquark/repo-ansi/hmcmooc@ec2-edx-configuration/playbooks/edx-west/stage-notifier-only.yml,1,0,0,0,0,0,1
2019-03-09 02:10:04.998714, /home/brokenquark/repo-ansi/hmcmooc@ec2-edx-configuration/playbooks/edx-east/edx_provision.yml,3,0,0,0,0,0,3
2019-03-09 02:10:05.004215, /home/brokenquark/repo-ansi/hmcmooc@ec2-edx-configuration/playbooks/edx-east/add-ubuntu-key.yml,1,0,0,0,0,0,1
2019-03-09 02:10:05.044532, /home/brokenquark/repo-ansi/hmcmooc@ec2-edx-configuration/playbooks/edx-east/remove-ubuntu-key.yml,1,0,0,0,0,0,1
2019-03-09 02:10:05.063800, /home/brokenquark/repo-ansi/hmcmooc@ec2-edx-configuration/playbooks/edx-east/edx_notifier.yml,5,0,0,0,0,0,5
2019-03-09 02:10:05.088413, /home/brokenquark/repo-ansi/hmcmooc@ec2-edx-configuration/playbooks/edx-east/ora2.yml,3,0,0,0,0,0,3
2019-03-09 02:10:05.122369, /home/brokenquark/repo-ansi/hmcmooc@ec2-edx-configuration/playbooks/edx-east/create_dbs.yml,4,0,0,0,0,0,4
2019-03-09 02:10:05.126803, /home/brokenquark/repo-ansi/hmcmooc@ec2-edx-configuration/playbooks/secure_example/vars/edxapp_ref_custom_vars.yml,2,0,0,0,0,0,2
2019-03-09 02:10:05.154736, /home/brokenquark/repo-ansi/hmcmooc@ec2-edx-configuration/playbooks/secure_example/vars/edxapp_ref_vars.yml,34,0,0,0,0,0,34
2019-03-09 02:10:05.156461, /home/brokenquark/repo-ansi/hmcmooc@ec2-edx-configuration/playbooks/secure_example/vars/edxapp_ref_users.yml,2,0,0,0,0,0,2
2019-03-09 02:10:05.158906, /home/brokenquark/repo-ansi/hmcmooc@ec2-edx-configuration/playbooks/secure_example/vars/gerrit.yml,7,0,0,0,0,0,7
2019-03-09 02:10:15.868298, /home/brokenquark/repo-ansi/jlund@streisand/playbooks/test-client.yml,2,0,0,0,0,0,2
2019-03-09 02:10:15.884435, /home/brokenquark/repo-ansi/jlund@streisand/playbooks/vagrant.yml,1,0,0,0,0,0,1
2019-03-09 02:10:15.894575, /home/brokenquark/repo-ansi/jlund@streisand/playbooks/provider-detect.yml,1,0,0,0,0,0,1
2019-03-09 02:10:15.910612, /home/brokenquark/repo-ansi/jlund@streisand/playbooks/python.yml,1,0,0,0,0,0,1
2019-03-09 02:10:15.950041, /home/brokenquark/repo-ansi/jlund@streisand/playbooks/cloud-status.yml,1,0,0,0,0,0,1
2019-03-09 02:10:15.976558, /home/brokenquark/repo-ansi/jlund@streisand/playbooks/streisand.yml,1,0,0,0,0,0,1
2019-03-09 02:10:16.042515, /home/brokenquark/repo-ansi/jlund@streisand/playbooks/localhost.yml,1,0,0,0,0,0,1
2019-03-09 02:10:16.053436, /home/brokenquark/repo-ansi/jlund@streisand/playbooks/roles/common/vars/main.yml,0,0,0,0,1,0,1
2019-03-09 02:10:16.072120, /home/brokenquark/repo-ansi/jlund@streisand/playbooks/roles/common/tasks/main.yml,3,0,0,0,0,0,3
2019-03-09 02:10:16.087177, /home/brokenquark/repo-ansi/jlund@streisand/playbooks/roles/download-and-verify/tasks/main.yml,2,0,0,0,0,0,2
2019-03-09 02:10:16.096239, /home/brokenquark/repo-ansi/jlund@streisand/playbooks/roles/wireguard/tasks/docs.yml,1,0,0,0,0,0,1
2019-03-09 02:10:16.118242, /home/brokenquark/repo-ansi/jlund@streisand/playbooks/roles/wireguard/tasks/main.yml,3,0,0,0,0,0,3
2019-03-09 02:10:16.151363, /home/brokenquark/repo-ansi/jlund@streisand/playbooks/roles/ec2-security-group/tasks/main.yml,0,0,0,14,0,0,14
2019-03-09 02:10:16.153903, /home/brokenquark/repo-ansi/jlund@streisand/playbooks/roles/certificates/defaults/main.yml,1,0,0,0,0,0,1
2019-03-09 02:10:16.163510, /home/brokenquark/repo-ansi/jlund@streisand/playbooks/roles/certificates/tasks/ca-server.yml,2,0,0,0,0,0,2
2019-03-09 02:10:16.171083, /home/brokenquark/repo-ansi/jlund@streisand/playbooks/roles/certificates/tasks/pkcs.yml,1,0,0,0,0,0,1
2019-03-09 02:10:16.178588, /home/brokenquark/repo-ansi/jlund@streisand/playbooks/roles/certificates/tasks/client.yml,1,0,0,0,0,0,1
2019-03-09 02:10:16.187783, /home/brokenquark/repo-ansi/jlund@streisand/playbooks/roles/ssh-forward/vars/mirror.yml,1,0,0,0,0,0,1
2019-03-09 02:10:16.194786, /home/brokenquark/repo-ansi/jlund@streisand/playbooks/roles/ssh-forward/tasks/docs.yml,1,0,0,0,0,0,1
2019-03-09 02:10:16.201885, /home/brokenquark/repo-ansi/jlund@streisand/playbooks/roles/ssh-forward/tasks/mirror.yml,2,0,0,0,0,0,2
2019-03-09 02:10:16.209098, /home/brokenquark/repo-ansi/jlund@streisand/playbooks/roles/ssh-forward/tasks/main.yml,8,0,0,0,0,0,8
2019-03-09 02:10:16.211844, /home/brokenquark/repo-ansi/jlund@streisand/playbooks/roles/streisand-gateway/vars/main.yml,1,0,0,0,0,0,1
2019-03-09 02:10:16.213315, /home/brokenquark/repo-ansi/jlund@streisand/playbooks/roles/streisand-gateway/defaults/main.yml,1,0,0,0,0,0,1
2019-03-09 02:10:16.223565, /home/brokenquark/repo-ansi/jlund@streisand/playbooks/roles/streisand-gateway/tasks/openssl.yml,2,0,0,0,0,0,2
2019-03-09 02:10:16.231347, /home/brokenquark/repo-ansi/jlund@streisand/playbooks/roles/streisand-gateway/tasks/docs.yml,1,0,0,0,0,0,1
2019-03-09 02:10:16.244588, /home/brokenquark/repo-ansi/jlund@streisand/playbooks/roles/streisand-gateway/tasks/main.yml,3,0,0,0,0,0,3
2019-03-09 02:10:16.254096, /home/brokenquark/repo-ansi/jlund@streisand/playbooks/roles/openconnect/vars/main.yml,1,0,0,0,0,0,1
2019-03-09 02:10:16.261100, /home/brokenquark/repo-ansi/jlund@streisand/playbooks/roles/openconnect/tasks/docs.yml,1,0,0,0,0,0,1
2019-03-09 02:10:16.269228, /home/brokenquark/repo-ansi/jlund@streisand/playbooks/roles/openconnect/tasks/mirror.yml,2,0,0,0,0,0,2
2019-03-09 02:10:16.287084, /home/brokenquark/repo-ansi/jlund@streisand/playbooks/roles/openconnect/tasks/main.yml,4,0,0,0,0,0,4
2019-03-09 02:10:16.292163, /home/brokenquark/repo-ansi/jlund@streisand/playbooks/roles/openconnect/tasks/install.yml,2,0,0,0,0,0,2
2019-03-09 02:10:16.303125, /home/brokenquark/repo-ansi/jlund@streisand/playbooks/roles/test-client/vars/main.yml,4,0,0,0,0,0,4
2019-03-09 02:10:16.311403, /home/brokenquark/repo-ansi/jlund@streisand/playbooks/roles/test-client/tasks/wireguard-profiletest.yml,1,0,0,0,0,0,1
2019-03-09 02:10:16.328964, /home/brokenquark/repo-ansi/jlund@streisand/playbooks/roles/test-client/tasks/shadowsocks.yml,2,0,0,0,0,0,2
2019-03-09 02:10:16.349855, /home/brokenquark/repo-ansi/jlund@streisand/playbooks/roles/test-client/tasks/stunnel.yml,1,0,0,0,0,0,1
2019-03-09 02:10:16.353524, /home/brokenquark/repo-ansi/jlund@streisand/playbooks/roles/test-client/tasks/openvpn.yml,1,0,0,0,0,0,1
2019-03-09 02:10:16.374048, /home/brokenquark/repo-ansi/jlund@streisand/playbooks/roles/test-client/tasks/main.yml,2,0,0,0,0,0,2
2019-03-09 02:10:16.387435, /home/brokenquark/repo-ansi/jlund@streisand/playbooks/roles/test-client/tasks/ssh-forward.yml,1,0,0,0,0,0,1
2019-03-09 02:10:16.391723, /home/brokenquark/repo-ansi/jlund@streisand/playbooks/roles/test-client/tasks/openvpn-profileget.yml,0,0,0,0,1,0,1
2019-03-09 02:10:16.412413, /home/brokenquark/repo-ansi/jlund@streisand/playbooks/roles/tor-bridge/vars/mirror-download.yml,1,0,0,0,0,0,1
2019-03-09 02:10:16.421051, /home/brokenquark/repo-ansi/jlund@streisand/playbooks/roles/tor-bridge/tasks/docs.yml,1,0,0,0,0,0,1
2019-03-09 02:10:16.443500, /home/brokenquark/repo-ansi/jlund@streisand/playbooks/roles/tor-bridge/tasks/main.yml,4,0,0,0,1,0,5
2019-03-09 02:10:16.446898, /home/brokenquark/repo-ansi/jlund@streisand/playbooks/roles/tor-bridge/tasks/mirror-common.yml,1,0,0,0,0,0,1
2019-03-09 02:10:16.449358, /home/brokenquark/repo-ansi/jlund@streisand/playbooks/roles/ssh/vars/main.yml,1,0,0,0,0,0,1
2019-03-09 02:10:16.453158, /home/brokenquark/repo-ansi/jlund@streisand/playbooks/roles/ssh/tasks/main.yml,1,0,0,0,0,0,1
2019-03-09 02:10:16.469220, /home/brokenquark/repo-ansi/jlund@streisand/playbooks/roles/gpg/tasks/main.yml,5,0,0,0,0,0,5
2019-03-09 02:10:16.470136, /home/brokenquark/repo-ansi/jlund@streisand/playbooks/roles/genesis-amazon/defaults/main.yml,1,0,0,0,0,0,1
2019-03-09 02:10:16.483568, /home/brokenquark/repo-ansi/jlund@streisand/playbooks/roles/genesis-amazon/tasks/main.yml,1,0,0,0,0,0,1
2019-03-09 02:10:16.492938, /home/brokenquark/repo-ansi/jlund@streisand/playbooks/roles/sysctl/vars/main.yml,27,0,0,0,0,0,27
2019-03-09 02:10:16.497680, /home/brokenquark/repo-ansi/jlund@streisand/playbooks/roles/genesis-digitalocean/defaults/main.yml,2,0,0,0,0,0,2
2019-03-09 02:10:16.515130, /home/brokenquark/repo-ansi/jlund@streisand/playbooks/roles/streisand-mirror/tasks/main.yml,1,0,0,0,0,0,1
2019-03-09 02:10:16.525176, /home/brokenquark/repo-ansi/jlund@streisand/playbooks/roles/genesis-azure/tasks/main.yml,2,0,0,0,0,0,2
2019-03-09 02:10:16.555642, /home/brokenquark/repo-ansi/jlund@streisand/playbooks/roles/validation/tasks/main.yml,0,0,0,0,5,0,5
2019-03-09 02:10:16.572358, /home/brokenquark/repo-ansi/jlund@streisand/playbooks/roles/tinyproxy/tasks/main.yml,4,0,0,0,0,0,4
2019-03-09 02:10:16.577123, /home/brokenquark/repo-ansi/jlund@streisand/playbooks/roles/openvpn/vars/mirror.yml,1,0,0,0,0,0,1
2019-03-09 02:10:16.580794, /home/brokenquark/repo-ansi/jlund@streisand/playbooks/roles/openvpn/vars/main.yml,1,0,0,0,0,0,1
2019-03-09 02:10:16.587166, /home/brokenquark/repo-ansi/jlund@streisand/playbooks/roles/openvpn/tasks/docs.yml,1,0,0,0,0,0,1
2019-03-09 02:10:16.597387, /home/brokenquark/repo-ansi/jlund@streisand/playbooks/roles/openvpn/tasks/mirror.yml,2,0,0,0,0,0,2
2019-03-09 02:10:16.621234, /home/brokenquark/repo-ansi/jlund@streisand/playbooks/roles/openvpn/tasks/install.yml,1,0,0,0,0,0,1
2019-03-09 02:10:16.639401, /home/brokenquark/repo-ansi/jlund@streisand/playbooks/roles/gce-network/tasks/main.yml,0,0,0,9,0,0,9
2019-03-09 02:10:16.651631, /home/brokenquark/repo-ansi/jlund@streisand/playbooks/roles/genesis-google/tasks/main.yml,1,0,0,0,0,0,1
2019-03-09 02:10:16.659989, /home/brokenquark/repo-ansi/jlund@streisand/playbooks/roles/nginx/tasks/main.yml,2,0,0,0,0,0,2
2019-03-09 02:10:16.661641, /home/brokenquark/repo-ansi/jlund@streisand/playbooks/roles/genesis-linode/defaults/main.yml,3,0,0,0,1,0,4
2019-03-09 02:10:16.678006, /home/brokenquark/repo-ansi/jlund@streisand/playbooks/roles/lets-encrypt/tasks/install.yml,1,0,0,0,0,0,1
2019-03-09 02:10:16.681489, /home/brokenquark/repo-ansi/jlund@streisand/playbooks/roles/stunnel/vars/mirror.yml,1,0,0,0,0,0,1
2019-03-09 02:10:16.682665, /home/brokenquark/repo-ansi/jlund@streisand/playbooks/roles/stunnel/vars/main.yml,1,0,0,0,0,0,1
2019-03-09 02:10:16.690375, /home/brokenquark/repo-ansi/jlund@streisand/playbooks/roles/stunnel/tasks/mirror.yml,1,0,0,0,0,0,1
2019-03-09 02:10:16.697663, /home/brokenquark/repo-ansi/jlund@streisand/playbooks/roles/stunnel/tasks/main.yml,1,0,0,0,0,0,1
2019-03-09 02:10:16.709451, /home/brokenquark/repo-ansi/jlund@streisand/playbooks/roles/shadowsocks/vars/main.yml,0,0,0,0,1,0,1
2019-03-09 02:10:16.711226, /home/brokenquark/repo-ansi/jlund@streisand/playbooks/roles/shadowsocks/defaults/main.yml,0,0,1,0,0,0,1
2019-03-09 02:10:16.713835, /home/brokenquark/repo-ansi/jlund@streisand/playbooks/roles/shadowsocks/tasks/docs.yml,1,0,0,0,0,0,1
2019-03-09 02:10:16.719101, /home/brokenquark/repo-ansi/jlund@streisand/playbooks/roles/shadowsocks/tasks/mirror.yml,2,0,0,0,0,0,2
2019-03-09 02:10:16.732071, /home/brokenquark/repo-ansi/jlund@streisand/playbooks/roles/shadowsocks/tasks/main.yml,2,0,0,0,0,0,2
2019-03-09 02:10:19.645156, /home/brokenquark/repo-ansi/kubenow@KubeNow/playbooks/roles/common/tasks/wait-nodes.yml,0,0,0,0,1,0,1
2019-03-09 02:10:19.647484, /home/brokenquark/repo-ansi/kubenow@KubeNow/playbooks/roles/common/tasks/workaround-RBAC.yml,0,0,0,0,1,0,1
2019-03-09 02:10:19.654184, /home/brokenquark/repo-ansi/kubenow@KubeNow/playbooks/roles/traefik/tasks/main.yml,0,0,0,0,2,0,2
2019-03-09 02:10:19.659626, /home/brokenquark/repo-ansi/kubenow@KubeNow/playbooks/roles/traefik/files/traefik-daemonset.yml,1,0,0,0,0,0,1
2019-03-09 02:10:19.687849, /home/brokenquark/repo-ansi/kubenow@KubeNow/playbooks/roles/weave-network/tasks/main.yml,0,0,0,0,2,0,2
2019-03-09 02:10:19.722815, /home/brokenquark/repo-ansi/kubenow@KubeNow/playbooks/roles/heketi-gluster/files/glusterfs-daemonset.yml,1,0,0,0,0,0,1
2019-03-09 02:10:19.735117, /home/brokenquark/repo-ansi/kubenow@KubeNow/playbooks/roles/nginx/templates/nginx-config.yaml,1,0,0,0,0,0,1
2019-03-09 02:10:19.949001, /home/brokenquark/repo-ansi/kubernetes-incubator@kargo/tests/cloud_playbooks/create-do.yml,1,0,0,0,0,0,1
2019-03-09 02:10:19.965656, /home/brokenquark/repo-ansi/kubernetes-incubator@kargo/tests/cloud_playbooks/upload-logs-gcs.yml,0,0,0,0,0,1,1
2019-03-09 02:10:22.021105, /home/brokenquark/repo-ansi/kubernetes-incubator@kubespray/tests/cloud_playbooks/create-do.yml,1,0,0,0,0,0,1
2019-03-09 02:10:22.036926, /home/brokenquark/repo-ansi/kubernetes-incubator@kubespray/tests/cloud_playbooks/upload-logs-gcs.yml,0,0,0,0,0,1,1
2019-03-09 02:10:24.177429, /home/brokenquark/repo-ansi/kubespray@kargo/tests/cloud_playbooks/create-do.yml,1,0,0,0,0,0,1
2019-03-09 02:10:24.193772, /home/brokenquark/repo-ansi/kubespray@kargo/tests/cloud_playbooks/upload-logs-gcs.yml,0,0,0,0,0,1,1
2019-03-09 02:10:41.792395, /home/brokenquark/repo-ansi/laincloud@lain/playbooks/roles/collectd/tasks/main.yaml,1,0,0,0,0,0,1
2019-03-09 02:10:41.810154, /home/brokenquark/repo-ansi/laincloud@lain/playbooks/roles/bootstrap-etcd/tasks/main.yaml,2,0,0,0,0,0,2
2019-03-09 02:10:41.853420, /home/brokenquark/repo-ansi/laincloud@lain/playbooks/roles/config/defaults/main.yaml,3,0,0,2,1,0,6
2019-03-09 02:10:41.877296, /home/brokenquark/repo-ansi/laincloud@lain/playbooks/roles/calico/tasks/main.yaml,1,0,0,0,0,0,1
2019-03-09 02:10:41.906827, /home/brokenquark/repo-ansi/laincloud@lain/playbooks/roles/swarm-upgrade/tasks/main.yaml,0,0,0,0,1,0,1
2019-03-09 02:10:41.923798, /home/brokenquark/repo-ansi/laincloud@lain/playbooks/roles/swarm-manage/tasks/main.yaml,0,0,0,0,1,0,1
2019-03-09 02:10:41.960514, /home/brokenquark/repo-ansi/laincloud@lain/playbooks/roles/networkd-preupgrade/tasks/main.yaml,0,0,0,0,1,0,1
2019-03-09 02:10:41.965644, /home/brokenquark/repo-ansi/laincloud@lain/playbooks/roles/node-disable-log-driver/tasks/main.yaml,1,0,0,0,0,0,1
2019-03-09 02:10:41.980943, /home/brokenquark/repo-ansi/laincloud@lain/playbooks/roles/bootstrap-webrouter-start/tasks/main.yaml,0,0,0,0,3,0,3
2019-03-09 02:10:42.037100, /home/brokenquark/repo-ansi/laincloud@lain/playbooks/roles/console-deploy/tasks/main.yaml,0,0,2,0,0,0,2
2019-03-09 02:10:42.043265, /home/brokenquark/repo-ansi/laincloud@lain/playbooks/roles/node-change-labels/tasks/main.yaml,1,0,0,0,0,0,1
2019-03-09 02:10:42.066130, /home/brokenquark/repo-ansi/laincloud@lain/playbooks/roles/moosefs/tasks/main.yaml,0,0,0,0,1,0,1
2019-03-09 02:10:42.088446, /home/brokenquark/repo-ansi/laincloud@lain/playbooks/roles/etcd/tasks/main.yaml,1,0,0,0,0,0,1
2019-03-09 02:11:07.905446, /home/brokenquark/repo-ansi/mantl@mantl/playbooks/host-connectivity.yml,0,0,0,0,1,0,1
2019-03-09 02:11:07.961091, /home/brokenquark/repo-ansi/mantl@mantl/playbooks/upgrade-1.0.3.yml,1,0,0,0,0,0,1
2019-03-09 02:11:09.461201, /home/brokenquark/repo-ansi/mcapuccini@KubeNow/playbooks/roles/common/tasks/wait-nodes.yml,0,0,0,0,1,0,1
2019-03-09 02:11:09.463514, /home/brokenquark/repo-ansi/mcapuccini@KubeNow/playbooks/roles/common/tasks/workaround-RBAC.yml,0,0,0,0,1,0,1
2019-03-09 02:11:09.469874, /home/brokenquark/repo-ansi/mcapuccini@KubeNow/playbooks/roles/traefik/tasks/main.yml,0,0,0,0,2,0,2
2019-03-09 02:11:09.475466, /home/brokenquark/repo-ansi/mcapuccini@KubeNow/playbooks/roles/traefik/files/traefik-daemonset.yml,1,0,0,0,0,0,1
2019-03-09 02:11:09.503237, /home/brokenquark/repo-ansi/mcapuccini@KubeNow/playbooks/roles/weave-network/tasks/main.yml,0,0,0,0,2,0,2
2019-03-09 02:11:09.539341, /home/brokenquark/repo-ansi/mcapuccini@KubeNow/playbooks/roles/heketi-gluster/files/glusterfs-daemonset.yml,1,0,0,0,0,0,1
2019-03-09 02:11:09.552261, /home/brokenquark/repo-ansi/mcapuccini@KubeNow/playbooks/roles/nginx/templates/nginx-config.yaml,1,0,0,0,0,0,1
2019-03-09 02:11:10.350844, /home/brokenquark/repo-ansi/michaelsteiner19@open-edx-configuration/playbooks/roles/jenkins_master/defaults/main.yml,1,0,0,0,0,0,1
2019-03-09 02:11:10.383283, /home/brokenquark/repo-ansi/michaelsteiner19@open-edx-configuration/playbooks/roles/jenkins_master/tasks/main.yml,1,0,1,0,4,0,6
2019-03-09 02:11:10.420032, /home/brokenquark/repo-ansi/michaelsteiner19@open-edx-configuration/playbooks/roles/common/tasks/main.yml,3,0,0,0,1,0,4
2019-03-09 02:11:10.437142, /home/brokenquark/repo-ansi/michaelsteiner19@open-edx-configuration/playbooks/roles/ad_hoc_reporting/tasks/main.yml,4,0,0,0,0,0,4
2019-03-09 02:11:10.452129, /home/brokenquark/repo-ansi/michaelsteiner19@open-edx-configuration/playbooks/roles/harprofiler/defaults/main.yml,1,0,0,0,0,0,1
2019-03-09 02:11:10.459380, /home/brokenquark/repo-ansi/michaelsteiner19@open-edx-configuration/playbooks/roles/harprofiler/tasks/main.yml,1,0,0,0,0,0,1
2019-03-09 02:11:10.467137, /home/brokenquark/repo-ansi/michaelsteiner19@open-edx-configuration/playbooks/roles/mongo_3_2/defaults/main.yml,7,0,0,0,0,0,7
2019-03-09 02:11:10.501906, /home/brokenquark/repo-ansi/michaelsteiner19@open-edx-configuration/playbooks/roles/mongo_3_2/tasks/main.yml,2,0,0,0,0,0,2
2019-03-09 02:11:10.527260, /home/brokenquark/repo-ansi/michaelsteiner19@open-edx-configuration/playbooks/roles/edxlocal/tasks/main.yml,2,0,0,0,0,0,2
2019-03-09 02:11:10.534842, /home/brokenquark/repo-ansi/michaelsteiner19@open-edx-configuration/playbooks/roles/newrelic-npi/defaults/main.yml,1,0,0,0,0,0,1
2019-03-09 02:11:10.550182, /home/brokenquark/repo-ansi/michaelsteiner19@open-edx-configuration/playbooks/roles/xserver/defaults/main.yml,2,0,0,0,0,0,2
2019-03-09 02:11:10.567795, /home/brokenquark/repo-ansi/michaelsteiner19@open-edx-configuration/playbooks/roles/xserver/tasks/deploy.yml,2,0,0,0,0,0,2
2019-03-09 02:11:10.575388, /home/brokenquark/repo-ansi/michaelsteiner19@open-edx-configuration/playbooks/roles/xserver/tasks/main.yml,1,0,0,0,0,0,1
2019-03-09 02:11:10.581549, /home/brokenquark/repo-ansi/michaelsteiner19@open-edx-configuration/playbooks/roles/test_build_server/defaults/main.yml,1,0,0,0,0,0,1
2019-03-09 02:11:10.592131, /home/brokenquark/repo-ansi/michaelsteiner19@open-edx-configuration/playbooks/roles/aws/defaults/main.yml,0,0,0,0,2,1,3
2019-03-09 02:11:10.601165, /home/brokenquark/repo-ansi/michaelsteiner19@open-edx-configuration/playbooks/roles/aws/tasks/main.yml,2,0,0,0,2,0,4
2019-03-09 02:11:10.613947, /home/brokenquark/repo-ansi/michaelsteiner19@open-edx-configuration/playbooks/roles/forum/defaults/main.yml,3,0,0,1,0,0,4
2019-03-09 02:11:10.629932, /home/brokenquark/repo-ansi/michaelsteiner19@open-edx-configuration/playbooks/roles/forum/tasks/deploy.yml,1,0,0,0,0,0,1
2019-03-09 02:11:10.638466, /home/brokenquark/repo-ansi/michaelsteiner19@open-edx-configuration/playbooks/roles/forum/tasks/main.yml,2,0,0,0,0,0,2
2019-03-09 02:11:10.645782, /home/brokenquark/repo-ansi/michaelsteiner19@open-edx-configuration/playbooks/roles/go-agent/defaults/main.yml,1,0,0,0,0,0,1
2019-03-09 02:11:10.683102, /home/brokenquark/repo-ansi/michaelsteiner19@open-edx-configuration/playbooks/roles/edx_django_service/defaults/main.yml,2,0,0,0,0,0,2
2019-03-09 02:11:10.713113, /home/brokenquark/repo-ansi/michaelsteiner19@open-edx-configuration/playbooks/roles/edx_django_service/tasks/main.yml,2,0,0,0,0,0,2
2019-03-09 02:11:10.726458, /home/brokenquark/repo-ansi/michaelsteiner19@open-edx-configuration/playbooks/roles/hadoop_common/defaults/main.yml,1,0,0,0,0,0,1
2019-03-09 02:11:10.754592, /home/brokenquark/repo-ansi/michaelsteiner19@open-edx-configuration/playbooks/roles/hadoop_common/tasks/main.yml,4,0,0,0,2,0,6
2019-03-09 02:11:10.807339, /home/brokenquark/repo-ansi/michaelsteiner19@open-edx-configuration/playbooks/roles/redis/defaults/main.yml,1,1,0,0,0,0,2
2019-03-09 02:11:10.812623, /home/brokenquark/repo-ansi/michaelsteiner19@open-edx-configuration/playbooks/roles/redis/tasks/main.yml,1,0,0,0,0,0,1
2019-03-09 02:11:10.828850, /home/brokenquark/repo-ansi/michaelsteiner19@open-edx-configuration/playbooks/roles/git_clone/tasks/main.yml,1,0,0,0,0,0,1
2019-03-09 02:11:10.832370, /home/brokenquark/repo-ansi/michaelsteiner19@open-edx-configuration/playbooks/roles/elasticsearch/defaults/main.yml,1,0,0,0,0,0,1
2019-03-09 02:11:10.849528, /home/brokenquark/repo-ansi/michaelsteiner19@open-edx-configuration/playbooks/roles/testcourses/tasks/import_course.yml,1,0,0,0,0,0,1
2019-03-09 02:11:10.858426, /home/brokenquark/repo-ansi/michaelsteiner19@open-edx-configuration/playbooks/roles/antivirus/defaults/main.yml,1,0,0,0,0,0,1
2019-03-09 02:11:10.879736, /home/brokenquark/repo-ansi/michaelsteiner19@open-edx-configuration/playbooks/roles/logstash/tasks/main.yml,2,0,0,0,0,0,2
2019-03-09 02:11:10.894719, /home/brokenquark/repo-ansi/michaelsteiner19@open-edx-configuration/playbooks/roles/flower/defaults/main.yml,4,0,0,1,0,0,5
2019-03-09 02:11:10.923814, /home/brokenquark/repo-ansi/michaelsteiner19@open-edx-configuration/playbooks/roles/harstorage/defaults/main.yml,2,0,0,1,0,1,4
2019-03-09 02:11:10.940722, /home/brokenquark/repo-ansi/michaelsteiner19@open-edx-configuration/playbooks/roles/harstorage/tasks/main.yml,2,0,0,0,0,0,2
2019-03-09 02:11:10.954272, /home/brokenquark/repo-ansi/michaelsteiner19@open-edx-configuration/playbooks/roles/go-server/defaults/main.yml,3,3,0,0,0,0,6
2019-03-09 02:11:10.959093, /home/brokenquark/repo-ansi/michaelsteiner19@open-edx-configuration/playbooks/roles/go-server/tasks/setup_regular_backup.yml,1,0,0,0,0,0,1
2019-03-09 02:11:10.988141, /home/brokenquark/repo-ansi/michaelsteiner19@open-edx-configuration/playbooks/roles/go-server/tasks/main.yml,1,0,0,0,0,0,1
2019-03-09 02:11:11.002824, /home/brokenquark/repo-ansi/michaelsteiner19@open-edx-configuration/playbooks/roles/gh_mirror/defaults/main.yml,1,0,0,0,0,0,1
2019-03-09 02:11:11.014400, /home/brokenquark/repo-ansi/michaelsteiner19@open-edx-configuration/playbooks/roles/sqoop/defaults/main.yml,0,0,2,0,0,0,2
2019-03-09 02:11:11.048096, /home/brokenquark/repo-ansi/michaelsteiner19@open-edx-configuration/playbooks/roles/common_vars/defaults/main.yml,11,1,1,0,0,0,13
2019-03-09 02:11:11.050619, /home/brokenquark/repo-ansi/michaelsteiner19@open-edx-configuration/playbooks/roles/edx-sandbox/tasks/main.yml,1,0,0,0,0,0,1
2019-03-09 02:11:11.054949, /home/brokenquark/repo-ansi/michaelsteiner19@open-edx-configuration/playbooks/roles/server_utils/tasks/main.yml,0,0,0,0,1,0,1
2019-03-09 02:11:11.062430, /home/brokenquark/repo-ansi/michaelsteiner19@open-edx-configuration/playbooks/roles/elasticsearch-monitor/tasks/main.yml,1,0,0,0,0,0,1
2019-03-09 02:11:11.080332, /home/brokenquark/repo-ansi/michaelsteiner19@open-edx-configuration/playbooks/roles/graphite/defaults/main.yml,4,0,0,1,0,0,5
2019-03-09 02:11:11.128237, /home/brokenquark/repo-ansi/michaelsteiner19@open-edx-configuration/playbooks/roles/tools_jenkins/defaults/main.yml,0,0,0,0,1,0,1
2019-03-09 02:11:11.157913, /home/brokenquark/repo-ansi/michaelsteiner19@open-edx-configuration/playbooks/roles/rbenv/tasks/main.yml,2,0,0,0,0,0,2
2019-03-09 02:11:11.160597, /home/brokenquark/repo-ansi/michaelsteiner19@open-edx-configuration/playbooks/roles/user/defaults/main.yml,0,0,0,0,1,0,1
2019-03-09 02:11:11.184488, /home/brokenquark/repo-ansi/michaelsteiner19@open-edx-configuration/playbooks/roles/user/tasks/main.yml,4,0,0,0,0,0,4
2019-03-09 02:11:11.216125, /home/brokenquark/repo-ansi/michaelsteiner19@open-edx-configuration/playbooks/roles/ecommerce/defaults/main.yml,9,0,0,0,1,0,10
2019-03-09 02:11:11.243843, /home/brokenquark/repo-ansi/michaelsteiner19@open-edx-configuration/playbooks/roles/ecommerce/tasks/main.yml,0,0,0,0,1,0,1
2019-03-09 02:11:11.249109, /home/brokenquark/repo-ansi/michaelsteiner19@open-edx-configuration/playbooks/roles/newrelic/defaults/main.yml,0,0,0,0,0,1,1
2019-03-09 02:11:11.256322, /home/brokenquark/repo-ansi/michaelsteiner19@open-edx-configuration/playbooks/roles/newrelic/tasks/main.yml,1,0,0,0,0,0,1
2019-03-09 02:11:11.271617, /home/brokenquark/repo-ansi/michaelsteiner19@open-edx-configuration/playbooks/roles/alton/defaults/main.yml,6,0,0,0,0,0,6
2019-03-09 02:11:11.284507, /home/brokenquark/repo-ansi/michaelsteiner19@open-edx-configuration/playbooks/roles/alton/tasks/deploy.yml,1,0,0,0,0,0,1
2019-03-09 02:11:11.298548, /home/brokenquark/repo-ansi/michaelsteiner19@open-edx-configuration/playbooks/roles/haproxy/tasks/main.yml,1,0,0,0,0,0,1
2019-03-09 02:11:11.311955, /home/brokenquark/repo-ansi/michaelsteiner19@open-edx-configuration/playbooks/roles/gluster/tasks/main.yml,0,0,0,0,1,0,1
2019-03-09 02:11:11.316117, /home/brokenquark/repo-ansi/michaelsteiner19@open-edx-configuration/playbooks/roles/android_sdk/defaults/main.yml,1,0,0,0,0,0,1
2019-03-09 02:11:11.327070, /home/brokenquark/repo-ansi/michaelsteiner19@open-edx-configuration/playbooks/roles/android_sdk/tasks/main.yml,0,0,0,0,1,0,1
2019-03-09 02:11:11.328673, /home/brokenquark/repo-ansi/michaelsteiner19@open-edx-configuration/playbooks/roles/swapfile/defaults/main.yml,0,0,0,0,1,0,1
2019-03-09 02:11:11.343267, /home/brokenquark/repo-ansi/michaelsteiner19@open-edx-configuration/playbooks/roles/certs/defaults/main.yml,4,0,0,0,0,0,4
2019-03-09 02:11:11.357910, /home/brokenquark/repo-ansi/michaelsteiner19@open-edx-configuration/playbooks/roles/certs/tasks/deploy.yml,2,0,0,0,0,0,2
2019-03-09 02:11:11.373116, /home/brokenquark/repo-ansi/michaelsteiner19@open-edx-configuration/playbooks/roles/demo/defaults/main.yml,12,0,0,0,0,0,12
2019-03-09 02:11:11.381271, /home/brokenquark/repo-ansi/michaelsteiner19@open-edx-configuration/playbooks/roles/demo/tasks/deploy.yml,1,0,0,0,0,0,1
2019-03-09 02:11:11.385230, /home/brokenquark/repo-ansi/michaelsteiner19@open-edx-configuration/playbooks/roles/oraclejdk/defaults/main.yml,0,0,1,0,0,0,1
2019-03-09 02:11:11.392522, /home/brokenquark/repo-ansi/michaelsteiner19@open-edx-configuration/playbooks/roles/oraclejdk/tasks/main.yml,2,0,0,0,0,0,2
2019-03-09 02:11:11.402177, /home/brokenquark/repo-ansi/michaelsteiner19@open-edx-configuration/playbooks/roles/munin_node/tasks/main.yml,3,0,0,0,0,0,3
2019-03-09 02:11:11.410590, /home/brokenquark/repo-ansi/michaelsteiner19@open-edx-configuration/playbooks/roles/splunkforwarder/defaults/main.yml,0,1,0,0,0,0,1
2019-03-09 02:11:11.425468, /home/brokenquark/repo-ansi/michaelsteiner19@open-edx-configuration/playbooks/roles/splunkforwarder/tasks/main.yml,6,0,0,0,0,0,6
2019-03-09 02:11:11.441626, /home/brokenquark/repo-ansi/michaelsteiner19@open-edx-configuration/playbooks/roles/notifier/defaults/main.yml,2,3,0,0,0,0,5
2019-03-09 02:11:11.456088, /home/brokenquark/repo-ansi/michaelsteiner19@open-edx-configuration/playbooks/roles/notifier/tasks/deploy.yml,2,0,0,0,0,0,2
2019-03-09 02:11:11.479643, /home/brokenquark/repo-ansi/michaelsteiner19@open-edx-configuration/playbooks/roles/notifier/tasks/main.yml,1,0,0,0,0,0,1
2019-03-09 02:11:11.493325, /home/brokenquark/repo-ansi/michaelsteiner19@open-edx-configuration/playbooks/roles/automated/defaults/main.yml,1,0,0,0,0,0,1
2019-03-09 02:11:11.505542, /home/brokenquark/repo-ansi/michaelsteiner19@open-edx-configuration/playbooks/roles/automated/tasks/main.yml,1,0,0,0,0,0,1
2019-03-09 02:11:11.510584, /home/brokenquark/repo-ansi/michaelsteiner19@open-edx-configuration/playbooks/roles/edx_ansible/defaults/main.yml,1,0,0,0,0,0,1
2019-03-09 02:11:11.523249, /home/brokenquark/repo-ansi/michaelsteiner19@open-edx-configuration/playbooks/roles/edx_ansible/tasks/deploy.yml,1,0,0,0,0,0,1
2019-03-09 02:11:11.537915, /home/brokenquark/repo-ansi/michaelsteiner19@open-edx-configuration/playbooks/roles/security/tasks/security-ubuntu.yml,2,0,0,0,1,0,3
2019-03-09 02:11:11.545963, /home/brokenquark/repo-ansi/michaelsteiner19@open-edx-configuration/playbooks/roles/add_user/tasks/main.yml,2,0,0,0,0,0,2
2019-03-09 02:11:11.549904, /home/brokenquark/repo-ansi/michaelsteiner19@open-edx-configuration/playbooks/roles/neo4j/defaults/main.yml,4,0,0,1,0,0,5
2019-03-09 02:11:11.565262, /home/brokenquark/repo-ansi/michaelsteiner19@open-edx-configuration/playbooks/roles/neo4j/tasks/main.yml,2,0,0,0,0,0,2
2019-03-09 02:11:11.567223, /home/brokenquark/repo-ansi/michaelsteiner19@open-edx-configuration/playbooks/roles/snort/defaults/main.yml,0,0,2,0,0,1,3
2019-03-09 02:11:11.573392, /home/brokenquark/repo-ansi/michaelsteiner19@open-edx-configuration/playbooks/roles/snort/tasks/main.yml,4,0,0,0,0,0,4
2019-03-09 02:11:11.586874, /home/brokenquark/repo-ansi/michaelsteiner19@open-edx-configuration/playbooks/roles/mariadb/defaults/main.yml,3,0,0,0,0,0,3
2019-03-09 02:11:11.601027, /home/brokenquark/repo-ansi/michaelsteiner19@open-edx-configuration/playbooks/roles/mariadb/tasks/main.yml,2,0,0,0,0,0,2
2019-03-09 02:11:11.615554, /home/brokenquark/repo-ansi/michaelsteiner19@open-edx-configuration/playbooks/roles/mariadb/tasks/cluster.yml,2,1,0,0,0,0,3
2019-03-09 02:11:11.628619, /home/brokenquark/repo-ansi/michaelsteiner19@open-edx-configuration/playbooks/roles/kibana/tasks/main.yml,2,0,0,0,0,0,2
2019-03-09 02:11:11.646109, /home/brokenquark/repo-ansi/michaelsteiner19@open-edx-configuration/playbooks/roles/minos/tasks/main.yml,3,0,0,0,0,0,3
2019-03-09 02:11:11.648252, /home/brokenquark/repo-ansi/michaelsteiner19@open-edx-configuration/playbooks/roles/minos/meta/main.yml,1,0,0,0,0,0,1
2019-03-09 02:11:11.651352, /home/brokenquark/repo-ansi/michaelsteiner19@open-edx-configuration/playbooks/roles/openstack/defaults/main.yml,0,1,0,0,1,0,2
2019-03-09 02:11:11.658417, /home/brokenquark/repo-ansi/michaelsteiner19@open-edx-configuration/playbooks/roles/openstack/tasks/main.yml,2,0,0,0,0,0,2
2019-03-09 02:11:11.692121, /home/brokenquark/repo-ansi/michaelsteiner19@open-edx-configuration/playbooks/roles/jenkins_analytics/defaults/main.yml,9,2,0,0,0,0,11
2019-03-09 02:11:11.729432, /home/brokenquark/repo-ansi/michaelsteiner19@open-edx-configuration/playbooks/roles/jenkins_analytics/tasks/main.yml,4,0,0,0,0,0,4
2019-03-09 02:11:11.755081, /home/brokenquark/repo-ansi/michaelsteiner19@open-edx-configuration/playbooks/roles/gitreload/defaults/main.yml,1,0,0,0,0,0,1
2019-03-09 02:11:11.764819, /home/brokenquark/repo-ansi/michaelsteiner19@open-edx-configuration/playbooks/roles/gitreload/tasks/deploy.yml,1,0,0,0,0,0,1
2019-03-09 02:11:11.781182, /home/brokenquark/repo-ansi/michaelsteiner19@open-edx-configuration/playbooks/roles/devstack_sqlite_fix/defaults/main.yml,0,0,0,0,0,1,1
2019-03-09 02:11:11.796206, /home/brokenquark/repo-ansi/michaelsteiner19@open-edx-configuration/playbooks/roles/locust/defaults/main.yml,1,0,0,0,0,0,1
2019-03-09 02:11:11.804002, /home/brokenquark/repo-ansi/michaelsteiner19@open-edx-configuration/playbooks/roles/locust/tasks/main.yml,2,0,0,0,1,0,3
2019-03-09 02:11:11.813001, /home/brokenquark/repo-ansi/michaelsteiner19@open-edx-configuration/playbooks/roles/s3fs/defaults/main.yml,0,0,1,0,0,0,1
2019-03-09 02:11:11.996439, /home/brokenquark/repo-ansi/michaelsteiner19@open-edx-configuration/playbooks/roles/edxapp/defaults/main.yml,19,2,6,0,1,0,28
2019-03-09 02:11:12.007298, /home/brokenquark/repo-ansi/michaelsteiner19@open-edx-configuration/playbooks/roles/edxapp/tasks/python_sandbox_env.yml,2,0,0,0,0,0,2
2019-03-09 02:11:12.056703, /home/brokenquark/repo-ansi/michaelsteiner19@open-edx-configuration/playbooks/roles/edxapp/tasks/deploy.yml,2,0,0,0,1,0,3
2019-03-09 02:11:12.076233, /home/brokenquark/repo-ansi/michaelsteiner19@open-edx-configuration/playbooks/roles/edxapp/tasks/service_variant_config.yml,0,0,0,0,1,0,1
2019-03-09 02:11:12.093659, /home/brokenquark/repo-ansi/michaelsteiner19@open-edx-configuration/playbooks/roles/edxapp/tasks/main.yml,2,0,0,0,0,0,2
2019-03-09 02:11:12.109973, /home/brokenquark/repo-ansi/michaelsteiner19@open-edx-configuration/playbooks/roles/edx_notes_api/defaults/main.yml,3,0,0,0,0,0,3
2019-03-09 02:11:12.148255, /home/brokenquark/repo-ansi/michaelsteiner19@open-edx-configuration/playbooks/roles/rabbitmq/defaults/main.yml,5,0,0,0,0,0,5
2019-03-09 02:11:12.184715, /home/brokenquark/repo-ansi/michaelsteiner19@open-edx-configuration/playbooks/roles/rabbitmq/tasks/main.yml,7,0,0,0,1,0,8
2019-03-09 02:11:12.190002, /home/brokenquark/repo-ansi/michaelsteiner19@open-edx-configuration/playbooks/roles/analytics_pipeline/defaults/main.yml,2,0,0,0,0,0,2
2019-03-09 02:11:12.244092, /home/brokenquark/repo-ansi/michaelsteiner19@open-edx-configuration/playbooks/roles/insights/defaults/main.yml,7,0,1,0,0,0,8
2019-03-09 02:11:12.271113, /home/brokenquark/repo-ansi/michaelsteiner19@open-edx-configuration/playbooks/roles/splunk-server/defaults/main.yml,4,1,0,0,0,0,5
2019-03-09 02:11:12.288131, /home/brokenquark/repo-ansi/michaelsteiner19@open-edx-configuration/playbooks/roles/splunk-server/tasks/main.yml,3,0,0,0,0,0,3
2019-03-09 02:11:12.304090, /home/brokenquark/repo-ansi/michaelsteiner19@open-edx-configuration/playbooks/roles/ecomworker/defaults/main.yml,5,0,0,0,0,0,5
2019-03-09 02:11:12.341703, /home/brokenquark/repo-ansi/michaelsteiner19@open-edx-configuration/playbooks/roles/mount_ebs/tasks/main.yml,0,0,0,0,2,0,2
2019-03-09 02:11:12.349996, /home/brokenquark/repo-ansi/michaelsteiner19@open-edx-configuration/playbooks/roles/supervisor/defaults/main.yml,1,0,0,0,0,0,1
2019-03-09 02:11:12.374101, /home/brokenquark/repo-ansi/michaelsteiner19@open-edx-configuration/playbooks/roles/supervisor/tasks/main.yml,2,0,0,0,0,0,2
2019-03-09 02:11:12.383718, /home/brokenquark/repo-ansi/michaelsteiner19@open-edx-configuration/playbooks/roles/oauth2_proxy/defaults/main.yml,5,0,0,1,0,0,6
2019-03-09 02:11:12.400222, /home/brokenquark/repo-ansi/michaelsteiner19@open-edx-configuration/playbooks/roles/oauth2_proxy/tasks/main.yml,2,0,0,0,0,0,2
2019-03-09 02:11:12.408929, /home/brokenquark/repo-ansi/michaelsteiner19@open-edx-configuration/playbooks/roles/browsers/defaults/main.yml,0,0,1,0,0,3,4
2019-03-09 02:11:12.431518, /home/brokenquark/repo-ansi/michaelsteiner19@open-edx-configuration/playbooks/roles/browsers/tasks/main.yml,2,0,0,0,0,0,2
2019-03-09 02:11:12.434966, /home/brokenquark/repo-ansi/michaelsteiner19@open-edx-configuration/playbooks/roles/postfix_queue/defaults/main.yml,0,1,0,0,5,0,6
2019-03-09 02:11:12.446667, /home/brokenquark/repo-ansi/michaelsteiner19@open-edx-configuration/playbooks/roles/postfix_queue/tasks/main.yml,2,0,0,0,2,0,4
2019-03-09 02:11:12.450113, /home/brokenquark/repo-ansi/michaelsteiner19@open-edx-configuration/playbooks/roles/nltk/defaults/main.yml,0,0,3,0,0,3,6
2019-03-09 02:11:12.490595, /home/brokenquark/repo-ansi/michaelsteiner19@open-edx-configuration/playbooks/roles/analytics_api/defaults/main.yml,6,0,0,0,0,0,6
2019-03-09 02:11:12.514770, /home/brokenquark/repo-ansi/michaelsteiner19@open-edx-configuration/playbooks/roles/go-agent-docker-server/tasks/main.yml,1,0,0,0,0,0,1
2019-03-09 02:11:12.543549, /home/brokenquark/repo-ansi/michaelsteiner19@open-edx-configuration/playbooks/roles/jenkins_admin/tasks/main.yml,1,0,0,0,0,0,1
2019-03-09 02:11:12.556553, /home/brokenquark/repo-ansi/michaelsteiner19@open-edx-configuration/playbooks/roles/mongo_3_0/defaults/main.yml,7,0,0,0,0,0,7
2019-03-09 02:11:12.626735, /home/brokenquark/repo-ansi/michaelsteiner19@open-edx-configuration/playbooks/roles/mongo_3_0/tasks/main.yml,2,0,0,0,0,0,2
2019-03-09 02:11:12.660578, /home/brokenquark/repo-ansi/michaelsteiner19@open-edx-configuration/playbooks/roles/discovery/defaults/main.yml,3,1,0,0,0,0,4
2019-03-09 02:11:12.697941, /home/brokenquark/repo-ansi/michaelsteiner19@open-edx-configuration/playbooks/roles/apache/tasks/main.yml,3,0,0,0,0,0,3
2019-03-09 02:11:12.735876, /home/brokenquark/repo-ansi/michaelsteiner19@open-edx-configuration/playbooks/roles/xqwatcher/tasks/code_jail.yml,3,0,0,0,1,0,4
2019-03-09 02:11:12.771512, /home/brokenquark/repo-ansi/michaelsteiner19@open-edx-configuration/playbooks/roles/jenkins_worker/defaults/main.yml,1,0,0,0,0,1,2
2019-03-09 02:11:12.780271, /home/brokenquark/repo-ansi/michaelsteiner19@open-edx-configuration/playbooks/roles/jenkins_worker/tasks/system.yml,0,0,0,0,1,0,1
2019-03-09 02:11:12.786381, /home/brokenquark/repo-ansi/michaelsteiner19@open-edx-configuration/playbooks/roles/jenkins_worker/tasks/test_platform_worker.yml,0,0,0,0,1,0,1
2019-03-09 02:11:12.825166, /home/brokenquark/repo-ansi/michaelsteiner19@open-edx-configuration/playbooks/roles/jenkins_worker/meta/main.yml,1,0,0,0,0,0,1
2019-03-09 02:11:12.830165, /home/brokenquark/repo-ansi/michaelsteiner19@open-edx-configuration/playbooks/roles/aide/tasks/main.yml,1,0,0,0,0,0,1
2019-03-09 02:11:12.832032, /home/brokenquark/repo-ansi/michaelsteiner19@open-edx-configuration/playbooks/roles/datadog/defaults/main.yml,1,0,0,0,0,0,1
2019-03-09 02:11:12.843193, /home/brokenquark/repo-ansi/michaelsteiner19@open-edx-configuration/playbooks/roles/datadog/tasks/main.yml,1,0,0,0,0,0,1
2019-03-09 02:11:12.850333, /home/brokenquark/repo-ansi/michaelsteiner19@open-edx-configuration/playbooks/roles/vhost/defaults/main.yml,3,0,0,0,0,0,3
2019-03-09 02:11:12.873143, /home/brokenquark/repo-ansi/michaelsteiner19@open-edx-configuration/playbooks/roles/vhost/tasks/main.yml,3,0,0,0,0,0,3
2019-03-09 02:11:12.911110, /home/brokenquark/repo-ansi/michaelsteiner19@open-edx-configuration/playbooks/roles/xqueue/defaults/main.yml,5,0,0,0,0,0,5
2019-03-09 02:11:12.947546, /home/brokenquark/repo-ansi/michaelsteiner19@open-edx-configuration/playbooks/roles/xqueue/tasks/deploy.yml,1,0,0,0,0,0,1
2019-03-09 02:11:13.025895, /home/brokenquark/repo-ansi/michaelsteiner19@open-edx-configuration/playbooks/roles/grafana/defaults/main.yml,19,2,0,0,0,0,21
2019-03-09 02:11:13.036111, /home/brokenquark/repo-ansi/michaelsteiner19@open-edx-configuration/playbooks/roles/grafana/tasks/main.yml,1,0,0,0,0,0,1
2019-03-09 02:11:13.061000, /home/brokenquark/repo-ansi/michaelsteiner19@open-edx-configuration/playbooks/roles/nginx/defaults/main.yml,2,0,0,0,0,0,2
2019-03-09 02:11:13.112933, /home/brokenquark/repo-ansi/michaelsteiner19@open-edx-configuration/playbooks/roles/nginx/tasks/main.yml,16,1,1,0,0,0,18
2019-03-09 02:11:13.122986, /home/brokenquark/repo-ansi/michaelsteiner19@open-edx-configuration/playbooks/roles/mongo_2_6/defaults/main.yml,7,0,0,0,0,0,7
2019-03-09 02:11:13.159396, /home/brokenquark/repo-ansi/michaelsteiner19@open-edx-configuration/playbooks/roles/mongo_2_6/tasks/main.yml,3,0,0,0,0,0,3
2019-03-09 02:11:13.162953, /home/brokenquark/repo-ansi/michaelsteiner19@open-edx-configuration/playbooks/roles/shibboleth/defaults/main.yml,3,0,1,0,0,0,4
2019-03-09 02:11:13.168388, /home/brokenquark/repo-ansi/michaelsteiner19@open-edx-configuration/playbooks/roles/shibboleth/tasks/main.yml,1,0,0,0,0,0,1
2019-03-09 02:11:13.193681, /home/brokenquark/repo-ansi/michaelsteiner19@open-edx-configuration/playbooks/roles/credentials/defaults/main.yml,4,0,0,0,1,0,5
2019-03-09 02:11:13.222301, /home/brokenquark/repo-ansi/michaelsteiner19@open-edx-configuration/playbooks/roles/credentials/tasks/main.yml,2,0,0,0,0,0,2
2019-03-09 02:11:13.233373, /home/brokenquark/repo-ansi/michaelsteiner19@open-edx-configuration/playbooks/roles/jscover/defaults/main.yml,0,0,1,0,0,0,1
2019-03-09 02:11:13.250536, /home/brokenquark/repo-ansi/michaelsteiner19@open-edx-configuration/playbooks/roles/edx_service/tasks/main.yml,1,0,0,0,0,0,1
2019-03-09 02:11:13.260188, /home/brokenquark/repo-ansi/michaelsteiner19@open-edx-configuration/playbooks/roles/hive/defaults/main.yml,2,0,1,0,0,0,3
2019-03-09 02:11:13.279922, /home/brokenquark/repo-ansi/michaelsteiner19@open-edx-configuration/playbooks/roles/local_dev/defaults/main.yml,1,0,0,0,0,0,1
2019-03-09 02:11:13.296530, /home/brokenquark/repo-ansi/michaelsteiner19@open-edx-configuration/playbooks/roles/local_dev/tasks/main.yml,1,0,0,0,0,0,1
2019-03-09 02:11:13.315232, /home/brokenquark/repo-ansi/michaelsteiner19@open-edx-configuration/playbooks/roles/jenkins_common/defaults/main.yml,1,2,1,0,0,0,4
2019-03-09 02:11:13.340696, /home/brokenquark/repo-ansi/michaelsteiner19@open-edx-configuration/playbooks/roles/jenkins_common/tasks/main.yml,2,0,0,0,0,0,2
2019-03-09 02:11:13.346906, /home/brokenquark/repo-ansi/michaelsteiner19@open-edx-configuration/playbooks/roles/cassandra/defaults/main.yml,1,0,0,0,0,0,1
2019-03-09 02:11:13.356851, /home/brokenquark/repo-ansi/michaelsteiner19@open-edx-configuration/playbooks/roles/cassandra/tasks/main.yml,0,0,1,0,0,0,1
2019-03-09 02:11:13.443160, /home/brokenquark/repo-ansi/michaelsteiner19@open-edx-configuration/playbooks/edx-east/mongo_rolling_upgrade.yml,3,0,0,0,0,0,3
2019-03-09 02:11:13.511227, /home/brokenquark/repo-ansi/michaelsteiner19@open-edx-configuration/playbooks/edx-east/promote_rds_secondary.yml,0,1,0,0,0,0,1
2019-03-09 02:11:13.527352, /home/brokenquark/repo-ansi/michaelsteiner19@open-edx-configuration/playbooks/edx-east/populate_configuration_model.yml,1,0,0,0,0,0,1
2019-03-09 02:11:13.560306, /home/brokenquark/repo-ansi/michaelsteiner19@open-edx-configuration/playbooks/edx-east/edx_provision.yml,3,0,0,0,0,0,3
2019-03-09 02:11:13.570992, /home/brokenquark/repo-ansi/michaelsteiner19@open-edx-configuration/playbooks/edx-east/add-ubuntu-key.yml,1,0,0,0,0,0,1
2019-03-09 02:11:13.609441, /home/brokenquark/repo-ansi/michaelsteiner19@open-edx-configuration/playbooks/edx-east/remove-ubuntu-key.yml,1,0,0,0,0,0,1
2019-03-09 02:11:13.635999, /home/brokenquark/repo-ansi/michaelsteiner19@open-edx-configuration/playbooks/edx-east/legacy_certificates.yml,2,0,0,0,0,0,2
2019-03-09 02:11:13.672885, /home/brokenquark/repo-ansi/michaelsteiner19@open-edx-configuration/playbooks/edx-east/mongo_upgrade_hidden_secondaries.yml,1,0,0,0,1,0,2
2019-03-09 02:11:13.690595, /home/brokenquark/repo-ansi/michaelsteiner19@open-edx-configuration/playbooks/edx-east/ora2.yml,3,0,0,0,0,0,3
2019-03-09 02:11:13.715352, /home/brokenquark/repo-ansi/michaelsteiner19@open-edx-configuration/playbooks/sample_vars/passwords.yml,3,42,0,0,0,0,45
2019-03-09 02:11:13.725051, /home/brokenquark/repo-ansi/michaelsteiner19@open-edx-configuration/playbooks/sample_vars/test-mongo.yml,12,0,0,0,0,0,12
2019-03-09 02:11:13.985964, /home/brokenquark/repo-ansi/mozilla@123done/ansible/playbooks/app.yml,1,0,0,0,0,0,1
2019-03-09 02:11:13.993074, /home/brokenquark/repo-ansi/mozilla@123done/ansible/playbooks/roles/common/tasks/main.yml,2,0,0,0,0,0,2
2019-03-09 02:11:14.000039, /home/brokenquark/repo-ansi/mozilla@123done/ansible/playbooks/roles/321done/tasks/main.yml,1,0,0,0,0,0,1
2019-03-09 02:11:14.001279, /home/brokenquark/repo-ansi/mozilla@123done/ansible/playbooks/roles/321done/handlers/main.yml,1,0,0,0,0,0,1
2019-03-09 02:11:14.004013, /home/brokenquark/repo-ansi/mozilla@123done/ansible/playbooks/roles/123done/tasks/main.yml,1,0,0,0,0,0,1
2019-03-09 02:11:14.005264, /home/brokenquark/repo-ansi/mozilla@123done/ansible/playbooks/roles/123done/handlers/main.yml,1,0,0,0,0,0,1
2019-03-09 02:11:14.250545, /home/brokenquark/repo-ansi/negritobomb@edxplat/playbooks/roles/jenkins_master/defaults/main.yml,1,0,1,0,0,0,2
2019-03-09 02:11:14.264449, /home/brokenquark/repo-ansi/negritobomb@edxplat/playbooks/roles/jenkins_master/tasks/main.yml,0,0,0,0,4,0,4
2019-03-09 02:11:14.276960, /home/brokenquark/repo-ansi/negritobomb@edxplat/playbooks/roles/common/defaults/main.yml,11,1,2,0,0,0,14
2019-03-09 02:11:14.288325, /home/brokenquark/repo-ansi/negritobomb@edxplat/playbooks/roles/common/tasks/main.yml,0,0,0,0,1,0,1
2019-03-09 02:11:14.292282, /home/brokenquark/repo-ansi/negritobomb@edxplat/playbooks/roles/harprofiler/defaults/main.yml,1,0,0,0,0,0,1
2019-03-09 02:11:14.319353, /home/brokenquark/repo-ansi/negritobomb@edxplat/playbooks/roles/gerrit/defaults/main.yml,1,0,0,0,0,0,1
2019-03-09 02:11:14.342686, /home/brokenquark/repo-ansi/negritobomb@edxplat/playbooks/roles/xserver/defaults/main.yml,2,0,0,0,0,0,2
2019-03-09 02:11:14.363103, /home/brokenquark/repo-ansi/negritobomb@edxplat/playbooks/roles/test_build_server/defaults/main.yml,1,0,0,0,0,0,1
2019-03-09 02:11:14.371882, /home/brokenquark/repo-ansi/negritobomb@edxplat/playbooks/roles/aws/defaults/main.yml,3,0,1,0,1,1,6
2019-03-09 02:11:14.380377, /home/brokenquark/repo-ansi/negritobomb@edxplat/playbooks/roles/aws/tasks/main.yml,1,0,0,0,0,0,1
2019-03-09 02:11:14.391226, /home/brokenquark/repo-ansi/negritobomb@edxplat/playbooks/roles/forum/defaults/main.yml,3,0,0,1,0,0,4
2019-03-09 02:11:14.424314, /home/brokenquark/repo-ansi/negritobomb@edxplat/playbooks/roles/analytics-api/defaults/main.yml,9,0,0,0,0,0,9
2019-03-09 02:11:14.459453, /home/brokenquark/repo-ansi/negritobomb@edxplat/playbooks/roles/ora/defaults/main.yml,7,0,0,0,0,0,7
2019-03-09 02:11:14.486341, /home/brokenquark/repo-ansi/negritobomb@edxplat/playbooks/roles/redis/defaults/main.yml,1,1,0,0,0,0,2
2019-03-09 02:11:14.492137, /home/brokenquark/repo-ansi/negritobomb@edxplat/playbooks/roles/elasticsearch/defaults/main.yml,1,0,0,0,0,0,1
2019-03-09 02:11:14.505631, /home/brokenquark/repo-ansi/negritobomb@edxplat/playbooks/roles/antivirus/defaults/main.yml,1,0,0,0,0,0,1
2019-03-09 02:11:14.524016, /home/brokenquark/repo-ansi/negritobomb@edxplat/playbooks/roles/flower/defaults/main.yml,3,0,0,1,0,0,4
2019-03-09 02:11:14.533411, /home/brokenquark/repo-ansi/negritobomb@edxplat/playbooks/roles/gh_mirror/defaults/main.yml,1,0,0,0,0,0,1
2019-03-09 02:11:14.541857, /home/brokenquark/repo-ansi/negritobomb@edxplat/playbooks/roles/devpi/defaults/main.yml,2,0,0,0,0,0,2
2019-03-09 02:11:14.567863, /home/brokenquark/repo-ansi/negritobomb@edxplat/playbooks/roles/user/defaults/main.yml,0,0,0,0,1,0,1
2019-03-09 02:11:14.589436, /home/brokenquark/repo-ansi/negritobomb@edxplat/playbooks/roles/newrelic/tasks/newrelic-logwatcher.yml,1,0,0,0,0,0,1
2019-03-09 02:11:14.605622, /home/brokenquark/repo-ansi/negritobomb@edxplat/playbooks/roles/newrelic/meta/main.yml,2,0,0,0,0,0,2
2019-03-09 02:11:14.611055, /home/brokenquark/repo-ansi/negritobomb@edxplat/playbooks/roles/alton/defaults/main.yml,4,0,0,0,0,0,4
2019-03-09 02:11:14.642857, /home/brokenquark/repo-ansi/negritobomb@edxplat/playbooks/roles/gluster/tasks/main.yml,0,0,0,0,1,0,1
2019-03-09 02:11:14.651832, /home/brokenquark/repo-ansi/negritobomb@edxplat/playbooks/roles/certs/defaults/main.yml,4,0,0,0,0,0,4
2019-03-09 02:11:14.675523, /home/brokenquark/repo-ansi/negritobomb@edxplat/playbooks/roles/demo/defaults/main.yml,6,0,0,0,0,0,6
2019-03-09 02:11:14.684150, /home/brokenquark/repo-ansi/negritobomb@edxplat/playbooks/roles/oraclejdk/defaults/main.yml,0,0,1,0,0,0,1
2019-03-09 02:11:14.693737, /home/brokenquark/repo-ansi/negritobomb@edxplat/playbooks/roles/splunkforwarder/defaults/main.yml,0,1,0,0,0,0,1
2019-03-09 02:11:14.706774, /home/brokenquark/repo-ansi/negritobomb@edxplat/playbooks/roles/splunkforwarder/tasks/main.yml,1,0,0,0,0,0,1
2019-03-09 02:11:14.724771, /home/brokenquark/repo-ansi/negritobomb@edxplat/playbooks/roles/notifier/defaults/main.yml,2,2,0,0,0,0,4
2019-03-09 02:11:14.753369, /home/brokenquark/repo-ansi/negritobomb@edxplat/playbooks/roles/edx_ansible/defaults/main.yml,1,0,0,0,0,0,1
2019-03-09 02:11:14.780123, /home/brokenquark/repo-ansi/negritobomb@edxplat/playbooks/roles/snort/defaults/main.yml,0,0,2,0,0,1,3
2019-03-09 02:11:14.795829, /home/brokenquark/repo-ansi/negritobomb@edxplat/playbooks/roles/mariadb/defaults/main.yml,3,0,0,0,0,0,3
2019-03-09 02:11:14.842373, /home/brokenquark/repo-ansi/negritobomb@edxplat/playbooks/roles/gitreload/defaults/main.yml,1,0,0,0,0,0,1
2019-03-09 02:11:14.869939, /home/brokenquark/repo-ansi/negritobomb@edxplat/playbooks/roles/s3fs/defaults/main.yml,0,0,1,0,0,0,1
2019-03-09 02:11:14.880851, /home/brokenquark/repo-ansi/negritobomb@edxplat/playbooks/roles/mongo/defaults/main.yml,7,0,1,0,0,0,8
2019-03-09 02:11:14.986619, /home/brokenquark/repo-ansi/negritobomb@edxplat/playbooks/roles/edxapp/defaults/main.yml,15,2,4,0,1,0,22
2019-03-09 02:11:15.045638, /home/brokenquark/repo-ansi/negritobomb@edxplat/playbooks/roles/edxapp/tasks/deploy.yml,0,0,0,0,3,0,3
2019-03-09 02:11:15.088711, /home/brokenquark/repo-ansi/negritobomb@edxplat/playbooks/roles/rabbitmq/defaults/main.yml,5,0,2,0,0,1,8
2019-03-09 02:11:15.102943, /home/brokenquark/repo-ansi/negritobomb@edxplat/playbooks/roles/rabbitmq/tasks/main.yml,1,0,0,0,1,0,2
2019-03-09 02:11:15.121790, /home/brokenquark/repo-ansi/negritobomb@edxplat/playbooks/roles/insights/defaults/main.yml,7,0,1,0,0,0,8
2019-03-09 02:11:15.141502, /home/brokenquark/repo-ansi/negritobomb@edxplat/playbooks/roles/supervisor/defaults/main.yml,1,0,0,0,0,0,1
2019-03-09 02:11:15.156053, /home/brokenquark/repo-ansi/negritobomb@edxplat/playbooks/roles/browsers/defaults/main.yml,0,0,1,0,0,1,2
2019-03-09 02:11:15.161828, /home/brokenquark/repo-ansi/negritobomb@edxplat/playbooks/roles/nltk/defaults/main.yml,0,0,3,0,0,3,6
2019-03-09 02:11:15.175982, /home/brokenquark/repo-ansi/negritobomb@edxplat/playbooks/roles/discern/defaults/main.yml,3,0,1,0,0,1,5
2019-03-09 02:11:15.193589, /home/brokenquark/repo-ansi/negritobomb@edxplat/playbooks/roles/discern/tasks/main.yml,0,0,0,0,1,0,1
2019-03-09 02:11:15.252565, /home/brokenquark/repo-ansi/negritobomb@edxplat/playbooks/roles/xqwatcher/defaults/main.yml,5,0,0,0,0,0,5
2019-03-09 02:11:15.278808, /home/brokenquark/repo-ansi/negritobomb@edxplat/playbooks/roles/jenkins_worker/defaults/main.yml,1,0,1,0,0,2,4
2019-03-09 02:11:15.290363, /home/brokenquark/repo-ansi/negritobomb@edxplat/playbooks/roles/jenkins_worker/tasks/system.yml,0,0,0,0,2,0,2
2019-03-09 02:11:15.306493, /home/brokenquark/repo-ansi/negritobomb@edxplat/playbooks/roles/datadog/defaults/main.yml,1,0,0,0,0,0,1
2019-03-09 02:11:15.323083, /home/brokenquark/repo-ansi/negritobomb@edxplat/playbooks/roles/xqueue/defaults/main.yml,5,0,0,0,0,0,5
2019-03-09 02:11:15.352335, /home/brokenquark/repo-ansi/negritobomb@edxplat/playbooks/roles/nginx/defaults/main.yml,2,0,0,0,0,0,2
2019-03-09 02:11:15.372986, /home/brokenquark/repo-ansi/negritobomb@edxplat/playbooks/roles/shibboleth/defaults/main.yml,3,0,1,0,0,0,4
2019-03-09 02:11:15.388642, /home/brokenquark/repo-ansi/negritobomb@edxplat/playbooks/roles/local_dev/defaults/main.yml,1,0,0,0,0,0,1
2019-03-09 02:11:15.410759, /home/brokenquark/repo-ansi/negritobomb@edxplat/playbooks/edx-west/stage-worker.yml,1,0,0,0,0,0,1
2019-03-09 02:11:15.458857, /home/brokenquark/repo-ansi/negritobomb@edxplat/playbooks/edx-west/stage-notifier-only.yml,1,0,0,0,0,0,1
2019-03-09 02:11:15.560953, /home/brokenquark/repo-ansi/negritobomb@edxplat/playbooks/edx-east/edx_provision.yml,3,0,0,0,0,0,3
2019-03-09 02:11:15.569248, /home/brokenquark/repo-ansi/negritobomb@edxplat/playbooks/edx-east/add-ubuntu-key.yml,1,0,0,0,0,0,1
2019-03-09 02:11:15.610682, /home/brokenquark/repo-ansi/negritobomb@edxplat/playbooks/edx-east/remove-ubuntu-key.yml,1,0,0,0,0,0,1
2019-03-09 02:11:15.630564, /home/brokenquark/repo-ansi/negritobomb@edxplat/playbooks/edx-east/edx_notifier.yml,5,0,0,0,0,0,5
2019-03-09 02:11:15.657370, /home/brokenquark/repo-ansi/negritobomb@edxplat/playbooks/edx-east/ora2.yml,3,0,0,0,0,0,3
2019-03-09 02:11:15.694193, /home/brokenquark/repo-ansi/negritobomb@edxplat/playbooks/edx-east/create_dbs.yml,4,0,0,0,0,0,4
2019-03-09 02:11:15.701013, /home/brokenquark/repo-ansi/negritobomb@edxplat/playbooks/secure_example/vars/edxapp_ref_custom_vars.yml,2,0,0,0,0,0,2
2019-03-09 02:11:15.729827, /home/brokenquark/repo-ansi/negritobomb@edxplat/playbooks/secure_example/vars/edxapp_ref_vars.yml,34,0,0,0,0,0,34
2019-03-09 02:11:15.731601, /home/brokenquark/repo-ansi/negritobomb@edxplat/playbooks/secure_example/vars/edxapp_ref_users.yml,2,0,0,0,0,0,2
2019-03-09 02:11:15.734186, /home/brokenquark/repo-ansi/negritobomb@edxplat/playbooks/secure_example/vars/gerrit.yml,7,0,0,0,0,0,7
2019-03-09 02:11:21.393241, /home/brokenquark/repo-ansi/open-power-ref-design-toolkit@cluster-genesis/playbooks/activate_client_interfaces.yml,2,0,0,0,0,0,2
2019-03-09 02:11:21.407210, /home/brokenquark/repo-ansi/open-power-ref-design-toolkit@cluster-genesis/playbooks/tasks/create_interfaces.yml,4,0,0,0,0,0,4
2019-03-09 02:11:21.409927, /home/brokenquark/repo-ansi/open-power-ref-design-toolkit@cluster-genesis/playbooks/tasks/transfer_keys.yml,4,0,0,0,0,0,4
2019-03-09 02:11:21.420173, /home/brokenquark/repo-ansi/open-power-ref-design-toolkit@cluster-genesis/playbooks/tasks/transfer_inventory.yml,2,0,0,0,0,0,2
2019-03-09 02:11:22.172527, /home/brokenquark/repo-ansi/open-power-ref-design-toolkit@os-services/changes/openstack-ansible/playbooks/setup-pkvm.yml,1,0,0,0,0,0,1
2019-03-09 02:11:22.185753, /home/brokenquark/repo-ansi/open-power-ref-design-toolkit@os-services/changes/openstack-ansible/playbooks/os-neutron-install.yml,4,0,0,0,0,0,4
2019-03-09 02:11:22.235087, /home/brokenquark/repo-ansi/open-power-ref-design-toolkit@os-services/changes/openstack-ansible/playbooks/common-playbooks/neutron.yml,1,0,0,0,0,0,1
2019-03-09 02:11:22.279100, /home/brokenquark/repo-ansi/open-power-ref-design-toolkit@os-services/changes/openstack-ansible/playbooks/inventory/group_vars/all.yml,31,0,0,0,1,0,32
2019-03-09 02:11:22.318310, /home/brokenquark/repo-ansi/open-power-ref-design-toolkit@os-services/osa/playbooks/pre-deploy.yml,5,0,0,0,0,0,5
2019-03-09 02:11:22.319974, /home/brokenquark/repo-ansi/open-power-ref-design-toolkit@os-services/osa/playbooks/roles/osa_deployer/tasks/main.yml,1,0,0,0,0,0,1
2019-03-09 02:11:22.322657, /home/brokenquark/repo-ansi/open-power-ref-design-toolkit@os-services/osa/playbooks/roles/swift_hosts/defaults/main.yml,0,0,0,0,2,0,2
2019-03-09 02:11:22.362494, /home/brokenquark/repo-ansi/open-power-ref-design-toolkit@os-services/osa/playbooks/roles/known_hosts/tasks/main.yml,0,0,0,0,1,0,1
2019-03-09 02:11:22.445378, /home/brokenquark/repo-ansi/open-power-ref-design-toolkit@os-services/osa/dbaas/dbimage-builder/playbooks/tasks/update-image.yml,3,0,0,0,0,0,3
2019-03-09 02:11:22.487871, /home/brokenquark/repo-ansi/open-power-ref-design-toolkit@os-services/osa/dbaas/dbimage-builder/playbooks/tasks/install-dib.yml,1,0,0,0,0,0,1
2019-03-09 02:11:22.493620, /home/brokenquark/repo-ansi/open-power-ref-design-toolkit@os-services/osa/dbaas/dbimage-builder/playbooks/tasks/get-external-image-data.yml,1,0,0,0,0,0,1
2019-03-09 02:11:22.520703, /home/brokenquark/repo-ansi/open-power-ref-design-toolkit@os-services/osa/dbaas/dbimage-builder/playbooks/tasks/charm-init-controller.yml,1,0,0,0,0,0,1
2019-03-09 02:11:22.547171, /home/brokenquark/repo-ansi/open-power-ref-design-toolkit@os-services/osa/dbaas/dbimage-builder/playbooks/tasks/init-controller.yml,1,0,0,0,0,0,1
2019-03-09 02:11:22.805828, /home/brokenquark/repo-ansi/open-power-ref-design@os-services/changes/openstack-ansible/playbooks/setup-pkvm.yml,1,0,0,0,0,0,1
2019-03-09 02:11:22.818911, /home/brokenquark/repo-ansi/open-power-ref-design@os-services/changes/openstack-ansible/playbooks/os-neutron-install.yml,4,0,0,0,0,0,4
2019-03-09 02:11:22.866006, /home/brokenquark/repo-ansi/open-power-ref-design@os-services/changes/openstack-ansible/playbooks/common-playbooks/neutron.yml,1,0,0,0,0,0,1
2019-03-09 02:11:22.912138, /home/brokenquark/repo-ansi/open-power-ref-design@os-services/changes/openstack-ansible/playbooks/inventory/group_vars/all.yml,31,0,0,0,1,0,32
2019-03-09 02:11:22.951771, /home/brokenquark/repo-ansi/open-power-ref-design@os-services/osa/playbooks/pre-deploy.yml,5,0,0,0,0,0,5
2019-03-09 02:11:22.953484, /home/brokenquark/repo-ansi/open-power-ref-design@os-services/osa/playbooks/roles/osa_deployer/tasks/main.yml,1,0,0,0,0,0,1
2019-03-09 02:11:22.956254, /home/brokenquark/repo-ansi/open-power-ref-design@os-services/osa/playbooks/roles/swift_hosts/defaults/main.yml,0,0,0,0,2,0,2
2019-03-09 02:11:23.000417, /home/brokenquark/repo-ansi/open-power-ref-design@os-services/osa/playbooks/roles/known_hosts/tasks/main.yml,0,0,0,0,1,0,1
2019-03-09 02:11:23.084350, /home/brokenquark/repo-ansi/open-power-ref-design@os-services/osa/dbaas/dbimage-builder/playbooks/tasks/update-image.yml,3,0,0,0,0,0,3
2019-03-09 02:11:23.127876, /home/brokenquark/repo-ansi/open-power-ref-design@os-services/osa/dbaas/dbimage-builder/playbooks/tasks/install-dib.yml,1,0,0,0,0,0,1
2019-03-09 02:11:23.133589, /home/brokenquark/repo-ansi/open-power-ref-design@os-services/osa/dbaas/dbimage-builder/playbooks/tasks/get-external-image-data.yml,1,0,0,0,0,0,1
2019-03-09 02:11:23.160754, /home/brokenquark/repo-ansi/open-power-ref-design@os-services/osa/dbaas/dbimage-builder/playbooks/tasks/charm-init-controller.yml,1,0,0,0,0,0,1
2019-03-09 02:11:23.188335, /home/brokenquark/repo-ansi/open-power-ref-design@os-services/osa/dbaas/dbimage-builder/playbooks/tasks/init-controller.yml,1,0,0,0,0,0,1
2019-03-09 02:11:59.319610, /home/brokenquark/repo-ansi/openebs@openebs/e2e/ansible/playbooks/resiliency/test-network-failure/test-nw-failure-cleanup.yml,1,0,0,0,0,0,1
2019-03-09 02:11:59.324813, /home/brokenquark/repo-ansi/openebs@openebs/e2e/ansible/playbooks/resiliency/test-network-failure/test-nw-failure-vars.yml,2,0,0,0,0,1,3
2019-03-09 02:11:59.350979, /home/brokenquark/repo-ansi/openebs@openebs/e2e/ansible/playbooks/resiliency/test-network-failure/test-nw-failure.yml,6,0,0,0,0,0,6
2019-03-09 02:11:59.390734, /home/brokenquark/repo-ansi/openebs@openebs/e2e/ansible/playbooks/resiliency/test-ctrl-failure/test-ctrl-failure.yml,6,0,0,0,0,0,6
2019-03-09 02:11:59.399796, /home/brokenquark/repo-ansi/openebs@openebs/e2e/ansible/playbooks/resiliency/test-ctrl-failure/test-ctrl-failure-cleanup.yml,1,0,0,0,0,0,1
2019-03-09 02:11:59.402988, /home/brokenquark/repo-ansi/openebs@openebs/e2e/ansible/playbooks/resiliency/test-ctrl-failure/test-ctrl-failure-vars.yml,2,0,0,0,0,1,3
2019-03-09 02:11:59.455319, /home/brokenquark/repo-ansi/openebs@openebs/e2e/ansible/playbooks/resiliency/test-data-integrity/test-data-integrity.yml,2,0,0,0,0,0,2
2019-03-09 02:11:59.465661, /home/brokenquark/repo-ansi/openebs@openebs/e2e/ansible/playbooks/resiliency/test-k8s-master-failure/k8s-master-cleanup.yml,1,0,0,0,0,0,1
2019-03-09 02:11:59.500903, /home/brokenquark/repo-ansi/openebs@openebs/e2e/ansible/playbooks/resiliency/test-k8s-master-failure/k8s-master-failure.yml,3,0,0,0,0,0,3
2019-03-09 02:11:59.520445, /home/brokenquark/repo-ansi/openebs@openebs/e2e/ansible/playbooks/resiliency/test-node-failure/node-failure-task.yml,2,0,0,0,0,0,2
2019-03-09 02:11:59.537069, /home/brokenquark/repo-ansi/openebs@openebs/e2e/ansible/playbooks/resiliency/test-node-failure/test-node-failure.yml,2,0,0,0,0,0,2
2019-03-09 02:11:59.550116, /home/brokenquark/repo-ansi/openebs@openebs/e2e/ansible/playbooks/resiliency/test-node-failure/cleanup.yml,1,0,0,0,0,0,1
2019-03-09 02:11:59.552267, /home/brokenquark/repo-ansi/openebs@openebs/e2e/ansible/playbooks/resiliency/test-node-failure/test-node-failure-vars.yml,0,0,0,0,0,1,1
2019-03-09 02:11:59.567575, /home/brokenquark/repo-ansi/openebs@openebs/e2e/ansible/playbooks/resiliency/test-network-failure-rep/test-nw-failure-rep-cleanup.yml,1,0,0,0,0,0,1
2019-03-09 02:11:59.594438, /home/brokenquark/repo-ansi/openebs@openebs/e2e/ansible/playbooks/resiliency/test-network-failure-rep/test-nw-failure-rep.yml,6,0,0,0,0,0,6
2019-03-09 02:11:59.597431, /home/brokenquark/repo-ansi/openebs@openebs/e2e/ansible/playbooks/resiliency/test-network-failure-rep/test-nw-failure-rep-vars.yml,2,0,0,0,0,1,3
2019-03-09 02:11:59.607216, /home/brokenquark/repo-ansi/openebs@openebs/e2e/ansible/playbooks/resiliency/test-replica-quorum-failure/test-replica-quorum-failure-vars.yml,2,0,0,0,0,1,3
2019-03-09 02:11:59.613992, /home/brokenquark/repo-ansi/openebs@openebs/e2e/ansible/playbooks/resiliency/test-replica-quorum-failure/test-replica-quorum-failure-cleanup.yml,1,0,0,0,0,0,1
2019-03-09 02:11:59.634207, /home/brokenquark/repo-ansi/openebs@openebs/e2e/ansible/playbooks/resiliency/test-replica-quorum-failure/test-replica-quorum-failure.yml,5,0,0,0,0,0,5
2019-03-09 02:11:59.674824, /home/brokenquark/repo-ansi/openebs@openebs/e2e/ansible/playbooks/resiliency/test-kubelet-service-stop/test-kubelet-service-stop.yml,4,0,0,0,0,0,4
2019-03-09 02:11:59.695215, /home/brokenquark/repo-ansi/openebs@openebs/e2e/ansible/playbooks/resiliency/test-kubelet-service-stop/cleanup.yml,1,0,0,0,0,0,1
2019-03-09 02:11:59.705566, /home/brokenquark/repo-ansi/openebs@openebs/e2e/ansible/playbooks/resiliency/test-volume-capacity/test-volume-cleanup.yml,1,0,0,0,0,0,1
2019-03-09 02:11:59.735242, /home/brokenquark/repo-ansi/openebs@openebs/e2e/ansible/playbooks/resiliency/test-volume-capacity/test-volume-capacity.yml,2,0,0,0,0,0,2
2019-03-09 02:11:59.740930, /home/brokenquark/repo-ansi/openebs@openebs/e2e/ansible/playbooks/resiliency/test-disk-failure/test-disk-failure-vars.yml,0,0,0,0,0,1,1
2019-03-09 02:11:59.785381, /home/brokenquark/repo-ansi/openebs@openebs/e2e/ansible/playbooks/resiliency/test-disk-failure/test-disk-failure.yml,4,0,0,0,0,0,4
2019-03-09 02:11:59.793220, /home/brokenquark/repo-ansi/openebs@openebs/e2e/ansible/playbooks/resiliency/test-single-replica-failure/test-single-replica-failure-vars.yml,2,0,0,0,0,1,3
2019-03-09 02:11:59.830640, /home/brokenquark/repo-ansi/openebs@openebs/e2e/ansible/playbooks/resiliency/test-single-replica-failure/test-single-replica-failure.yml,6,0,0,0,0,0,6
2019-03-09 02:11:59.849910, /home/brokenquark/repo-ansi/openebs@openebs/e2e/ansible/playbooks/resiliency/test-single-replica-failure/test-single-replica-failure-cleanup.yml,1,0,0,0,0,0,1
2019-03-09 02:11:59.874911, /home/brokenquark/repo-ansi/openebs@openebs/e2e/ansible/playbooks/resiliency/test-node-eviction-out-of-disk/test-node-eviction-out-of-disk.yml,5,0,0,0,0,0,5
2019-03-09 02:11:59.878968, /home/brokenquark/repo-ansi/openebs@openebs/e2e/ansible/playbooks/resiliency/test-node-eviction-out-of-disk/test-node-eviction-out-of-disk-cleanup.yml,1,0,0,0,0,0,1
2019-03-09 02:11:59.883398, /home/brokenquark/repo-ansi/openebs@openebs/e2e/ansible/playbooks/resiliency/test-node-eviction-out-of-disk/test-node-eviction-out-of-disk-vars.yml,3,0,0,0,0,1,4
2019-03-09 02:11:59.891274, /home/brokenquark/repo-ansi/openebs@openebs/e2e/ansible/playbooks/compliance/iscsi/libiscsi-vars.yml,2,0,0,0,0,0,2
2019-03-09 02:11:59.924455, /home/brokenquark/repo-ansi/openebs@openebs/e2e/ansible/playbooks/compliance/iscsi/libiscsi.yml,2,0,0,0,0,0,2
2019-03-09 02:12:00.099338, /home/brokenquark/repo-ansi/openebs@openebs/e2e/ansible/playbooks/hyperconverged/test-resize-jiva-volume/resize-volume.yml,3,0,0,0,0,0,3
2019-03-09 02:12:00.137088, /home/brokenquark/repo-ansi/openebs@openebs/e2e/ansible/playbooks/hyperconverged/test-k8s-pvc-deletion/k8s_delete_pvc.yml,3,0,0,0,0,0,3
2019-03-09 02:12:00.140780, /home/brokenquark/repo-ansi/openebs@openebs/e2e/ansible/playbooks/hyperconverged/test-k8s-pvc-deletion/k8s-delete-pvc-vars.yml,2,0,0,0,0,0,2
2019-03-09 02:12:00.162151, /home/brokenquark/repo-ansi/openebs@openebs/e2e/ansible/playbooks/hyperconverged/percona-openebs-ownnamespace/openebs-percona-diffns-pod.yml,4,0,0,0,0,0,4
2019-03-09 02:12:00.168780, /home/brokenquark/repo-ansi/openebs@openebs/e2e/ansible/playbooks/hyperconverged/percona-openebs-ownnamespace/k8s-percona-openebs-pod-cleanup.yml,1,0,0,0,0,0,1
2019-03-09 02:12:00.173919, /home/brokenquark/repo-ansi/openebs@openebs/e2e/ansible/playbooks/hyperconverged/percona-openebs-ownnamespace/openebs-ns-vars.yml,2,0,0,0,0,1,3
2019-03-09 02:12:00.178770, /home/brokenquark/repo-ansi/openebs@openebs/e2e/ansible/playbooks/hyperconverged/test-scaleup-cassandra-pods/scaleup-vars.yml,2,0,0,0,0,0,2
2019-03-09 02:12:00.231476, /home/brokenquark/repo-ansi/openebs@openebs/e2e/ansible/playbooks/hyperconverged/test-scaleup-cassandra-pods/test-scaleup-cassandra-pods.yml,3,0,0,0,0,0,3
2019-03-09 02:12:00.244582, /home/brokenquark/repo-ansi/openebs@openebs/e2e/ansible/playbooks/hyperconverged/test-k8s-percona-mysql-pod/k8s-percona-pod-vars.yml,2,0,0,0,0,0,2
2019-03-09 02:12:00.249984, /home/brokenquark/repo-ansi/openebs@openebs/e2e/ansible/playbooks/hyperconverged/test-k8s-percona-mysql-pod/k8s-percona-pod-cleanup.yml,1,0,0,0,0,0,1
2019-03-09 02:12:00.269617, /home/brokenquark/repo-ansi/openebs@openebs/e2e/ansible/playbooks/hyperconverged/test-k8s-percona-mysql-pod/k8s-percona-pod.yml,4,0,0,0,0,0,4
2019-03-09 02:12:00.272199, /home/brokenquark/repo-ansi/openebs@openebs/e2e/ansible/playbooks/hyperconverged/test-scaleup-storage-replicas/vars.yml,2,0,0,0,0,1,3
2019-03-09 02:12:00.282738, /home/brokenquark/repo-ansi/openebs@openebs/e2e/ansible/playbooks/hyperconverged/test-scaleup-storage-replicas/cleanup.yml,1,0,0,0,0,0,1
2019-03-09 02:12:00.314936, /home/brokenquark/repo-ansi/openebs@openebs/e2e/ansible/playbooks/hyperconverged/test-scaleup-storage-replicas/test-scaleup-storage-replicas.yml,6,0,0,0,0,0,6
2019-03-09 02:12:00.318425, /home/brokenquark/repo-ansi/openebs@openebs/e2e/ansible/playbooks/hyperconverged/test-k8s-jupyter-server-pod/k8s-jupyter-pod-vars.yml,2,0,0,0,0,0,2
2019-03-09 02:12:00.334182, /home/brokenquark/repo-ansi/openebs@openebs/e2e/ansible/playbooks/hyperconverged/test-k8s-jupyter-server-pod/k8s-jupyter-pod.yml,4,0,0,0,0,0,4
2019-03-09 02:12:00.342828, /home/brokenquark/repo-ansi/openebs@openebs/e2e/ansible/playbooks/hyperconverged/test-k8s-jupyter-server-pod/k8s-jupyter-pod-cleanup.yml,1,0,0,0,0,0,1
2019-03-09 02:12:00.365295, /home/brokenquark/repo-ansi/openebs@openebs/e2e/ansible/playbooks/hyperconverged/test-k8s-drain-nodes/drain-node-jiva.yml,1,0,0,0,0,0,1
2019-03-09 02:12:00.367463, /home/brokenquark/repo-ansi/openebs@openebs/e2e/ansible/playbooks/hyperconverged/test-k8s-drain-nodes/replica_patch.yaml,1,0,0,0,0,0,1
2019-03-09 02:12:00.377392, /home/brokenquark/repo-ansi/openebs@openebs/e2e/ansible/playbooks/hyperconverged/test-k8s-drain-nodes/drain-node-cstor.yml,2,0,0,0,0,0,2
2019-03-09 02:12:00.388591, /home/brokenquark/repo-ansi/openebs@openebs/e2e/ansible/playbooks/hyperconverged/test-k8s-drain-nodes/test-drain-nodes.yml,3,0,0,0,0,0,3
2019-03-09 02:12:00.396429, /home/brokenquark/repo-ansi/openebs@openebs/e2e/ansible/playbooks/hyperconverged/test-k8s-drain-nodes/cleanup.yml,1,0,0,0,0,0,1
2019-03-09 02:12:00.398498, /home/brokenquark/repo-ansi/openebs@openebs/e2e/ansible/playbooks/hyperconverged/test-k8s-drain-nodes/kubectl-drain-vars.yml,2,0,0,0,0,0,2
2019-03-09 02:12:00.417335, /home/brokenquark/repo-ansi/openebs@openebs/e2e/ansible/playbooks/hyperconverged/test-k8s-crunchy-postgres/k8s-crunchy-pg.yml,4,0,0,0,0,0,4
2019-03-09 02:12:00.427878, /home/brokenquark/repo-ansi/openebs@openebs/e2e/ansible/playbooks/hyperconverged/test-k8s-crunchy-postgres/k8s-crunchy-pg-vars.yml,2,0,0,0,0,0,2
2019-03-09 02:12:00.451253, /home/brokenquark/repo-ansi/openebs@openebs/e2e/ansible/playbooks/hyperconverged/test-k8s-cassandra-pod/k8s-cassandra-pod.yml,5,0,0,0,0,0,5
2019-03-09 02:12:00.455258, /home/brokenquark/repo-ansi/openebs@openebs/e2e/ansible/playbooks/hyperconverged/test-k8s-cassandra-pod/k8s-cassandra-pod-vars.yml,2,0,0,0,0,0,2
2019-03-09 02:12:00.478906, /home/brokenquark/repo-ansi/openebs@openebs/e2e/ansible/playbooks/hyperconverged/test-k8s-jenkins-upgrade/k8s-jenkins-pod-upgrade-cleanup.yml,1,0,0,0,0,0,1
2019-03-09 02:12:00.512808, /home/brokenquark/repo-ansi/openebs@openebs/e2e/ansible/playbooks/hyperconverged/test-k8s-jenkins-upgrade/k8s-jenkins-upgrade.yml,4,0,0,0,0,0,4
2019-03-09 02:12:00.516512, /home/brokenquark/repo-ansi/openebs@openebs/e2e/ansible/playbooks/hyperconverged/test-k8s-storage-pool/storage-pool-vars.yml,2,0,0,0,0,0,2
2019-03-09 02:12:00.542288, /home/brokenquark/repo-ansi/openebs@openebs/e2e/ansible/playbooks/hyperconverged/test-k8s-storage-pool/test-storage-pool.yml,3,0,0,0,0,0,3
2019-03-09 02:12:00.545837, /home/brokenquark/repo-ansi/openebs@openebs/e2e/ansible/playbooks/hyperconverged/test-replica-node-affinity/replica_patch.yml,1,0,0,0,0,0,1
2019-03-09 02:12:00.547487, /home/brokenquark/repo-ansi/openebs@openebs/e2e/ansible/playbooks/hyperconverged/test-replica-node-affinity/replica-node-affinity-vars.yml,2,0,0,0,0,0,2
2019-03-09 02:12:00.585303, /home/brokenquark/repo-ansi/openebs@openebs/e2e/ansible/playbooks/hyperconverged/test-replica-node-affinity/replica-node-affinity.yml,4,0,0,0,0,0,4
2019-03-09 02:12:00.594750, /home/brokenquark/repo-ansi/openebs@openebs/e2e/ansible/playbooks/hyperconverged/test-k8s-memleak/memleak-cleanup.yml,1,0,0,0,0,0,1
2019-03-09 02:12:00.598190, /home/brokenquark/repo-ansi/openebs@openebs/e2e/ansible/playbooks/hyperconverged/test-k8s-memleak/memleak-vars.yml,2,0,0,0,0,0,2
2019-03-09 02:12:00.624670, /home/brokenquark/repo-ansi/openebs@openebs/e2e/ansible/playbooks/hyperconverged/test-k8s-memleak/memleak.yml,4,0,0,0,0,0,4
2019-03-09 02:12:00.628394, /home/brokenquark/repo-ansi/openebs@openebs/e2e/ansible/playbooks/hyperconverged/test-k8s-volume-taints/volume-taints-vars.yml,2,0,0,0,0,0,2
2019-03-09 02:12:00.677065, /home/brokenquark/repo-ansi/openebs@openebs/e2e/ansible/playbooks/hyperconverged/test-k8s-volume-taints/test-volume-taints.yml,1,0,0,0,0,0,1
2019-03-09 02:12:00.720630, /home/brokenquark/repo-ansi/openebs@openebs/e2e/ansible/playbooks/feature/data-integrity-fio/ha-di.yml,3,0,0,0,0,0,3
2019-03-09 02:12:00.729658, /home/brokenquark/repo-ansi/openebs@openebs/e2e/ansible/playbooks/feature/data-integrity-fio/ha-di-cleanup.yml,2,0,0,0,0,0,2
2019-03-09 02:12:00.783492, /home/brokenquark/repo-ansi/openebs@openebs/e2e/ansible/playbooks/feature/snapshots/kubectl_snapshot/test-kubectl-snapshot.yml,3,0,0,0,0,0,3
2019-03-09 02:12:00.789494, /home/brokenquark/repo-ansi/openebs@openebs/e2e/ansible/playbooks/feature/snapshots/simple-volume/snapshot-vars.yml,2,0,0,0,0,0,2
2019-03-09 02:12:00.833047, /home/brokenquark/repo-ansi/openebs@openebs/e2e/ansible/playbooks/feature/snapshots/simple-volume/snapshot.yml,5,0,0,0,0,0,5
2019-03-09 02:12:00.849530, /home/brokenquark/repo-ansi/openebs@openebs/e2e/ansible/playbooks/feature/snapshots/percona-mysql/mysql-snapshot-cleanup.yml,1,0,0,0,0,0,1
2019-03-09 02:12:00.877194, /home/brokenquark/repo-ansi/openebs@openebs/e2e/ansible/playbooks/feature/snapshots/percona-mysql/mysql-snapshot.yml,3,0,0,0,1,0,4
2019-03-09 02:12:00.890174, /home/brokenquark/repo-ansi/openebs@openebs/e2e/ansible/playbooks/feature/ha/ha-vars.yml,2,0,0,0,0,0,2
2019-03-09 02:12:00.894956, /home/brokenquark/repo-ansi/openebs@openebs/e2e/ansible/playbooks/feature/ha/ha-cleanup.yml,1,0,0,0,0,0,1
2019-03-09 02:12:00.931230, /home/brokenquark/repo-ansi/openebs@openebs/e2e/ansible/playbooks/feature/ha/ha.yml,4,0,0,0,0,0,4
2019-03-09 02:12:01.887139, /home/brokenquark/repo-ansi/openshift@openshift-ansible/playbooks/common/openshift-cluster/upgrades/pre/verify_cluster.yml,1,0,0,0,0,0,1
2019-03-09 02:12:02.016578, /home/brokenquark/repo-ansi/openshift@openshift-ansible/playbooks/aws/openshift-cluster/install.yml,1,0,0,0,0,0,1
2019-03-09 02:12:02.057185, /home/brokenquark/repo-ansi/openshift@openshift-ansible/playbooks/azure/openshift-cluster/build_base_image.yml,1,0,0,0,0,0,1
2019-03-09 02:12:02.077032, /home/brokenquark/repo-ansi/openshift@openshift-ansible/playbooks/azure/openshift-cluster/build_node_image.yml,2,0,0,0,0,0,2
2019-03-09 02:12:02.084331, /home/brokenquark/repo-ansi/openshift@openshift-ansible/playbooks/azure/openshift-cluster/group_vars/all/yum_repos.yml,19,0,1,0,0,1,21
2019-03-09 02:12:02.088637, /home/brokenquark/repo-ansi/openshift@openshift-ansible/playbooks/azure/openshift-cluster/tasks/provision_instance.yml,1,0,0,0,0,0,1
2019-03-09 02:12:02.161227, /home/brokenquark/repo-ansi/openshift@openshift-ansible/playbooks/openshift-master/private/redeploy-openshift-ca.yml,9,0,0,0,0,0,9
2019-03-09 02:12:02.170999, /home/brokenquark/repo-ansi/openshift@openshift-ansible/playbooks/openshift-master/private/certificates-backup.yml,0,0,0,0,0,1,1
2019-03-09 02:12:02.211059, /home/brokenquark/repo-ansi/openshift@openshift-ansible/playbooks/openshift-master/private/revert-client-ca.yml,1,0,0,0,0,0,1
2019-03-09 02:12:02.240405, /home/brokenquark/repo-ansi/openshift@openshift-ansible/playbooks/openshift-master/private/upgrade.yml,0,0,0,0,1,1,2
2019-03-09 02:12:02.247929, /home/brokenquark/repo-ansi/openshift@openshift-ansible/playbooks/openshift-master/private/validate_restart.yml,0,0,0,0,0,1,1
2019-03-09 02:12:02.250701, /home/brokenquark/repo-ansi/openshift@openshift-ansible/playbooks/openshift-master/private/tasks/restart_hosts.yml,0,0,0,0,1,0,1
2019-03-09 02:12:02.417596, /home/brokenquark/repo-ansi/openshift@openshift-ansible/playbooks/gcp/openshift-cluster/build_base_image.yml,2,0,0,0,0,1,3
2019-03-09 02:12:02.476890, /home/brokenquark/repo-ansi/openshift@openshift-ansible/playbooks/adhoc/setupnfs.yml,1,0,0,0,0,0,1
2019-03-09 02:12:02.542024, /home/brokenquark/repo-ansi/openshift@openshift-ansible/playbooks/adhoc/docker_loopback_to_lvm/docker_loopback_to_direct_lvm.yml,2,0,0,0,0,0,2
2019-03-09 02:12:02.553499, /home/brokenquark/repo-ansi/openshift@openshift-ansible/playbooks/adhoc/docker_loopback_to_lvm/ops-docker-loopback-to-direct-lvm.yml,2,0,0,0,0,0,2
2019-03-09 02:12:02.575966, /home/brokenquark/repo-ansi/openshift@openshift-ansible/playbooks/adhoc/grow_docker_vg/grow_docker_vg.yml,1,0,0,0,0,0,1
2019-03-09 02:12:02.581294, /home/brokenquark/repo-ansi/openshift@openshift-ansible/playbooks/adhoc/sdn_restart/oo-sdn-restart.yml,1,0,0,0,0,0,1
2019-03-09 02:12:02.598645, /home/brokenquark/repo-ansi/openshift@openshift-ansible/playbooks/adhoc/create_pv/create_pv.yaml,3,0,0,0,0,0,3
2019-03-09 02:12:02.608600, /home/brokenquark/repo-ansi/openshift@openshift-ansible/playbooks/adhoc/docker_storage_cleanup/docker_storage_cleanup.yml,1,0,0,0,1,0,2
2019-03-09 02:12:02.642250, /home/brokenquark/repo-ansi/openshift@openshift-ansible/playbooks/openstack/sample-inventory/group_vars/all.yml,4,0,0,0,2,0,6
2019-03-09 02:12:02.750892, /home/brokenquark/repo-ansi/openshift@openshift-ansible/playbooks/byo/calico/legacy_upgrade.yml,4,0,0,0,0,1,5
2019-03-09 02:12:02.855412, /home/brokenquark/repo-ansi/openshift@openshift-ansible/playbooks/init/version.yml,0,0,0,0,2,0,2
2019-03-09 02:12:02.970698, /home/brokenquark/repo-ansi/openshift@openshift-ansible/playbooks/openshift-hosted/private/create_persistent_volumes.yml,1,0,0,0,0,0,1
2019-03-09 02:12:02.988709, /home/brokenquark/repo-ansi/openshift@openshift-ansible/playbooks/openshift-hosted/private/redeploy-router-certificates.yml,1,0,0,0,0,0,1
2019-03-09 02:12:03.000719, /home/brokenquark/repo-ansi/openshift@openshift-ansible/playbooks/openshift-hosted/private/redeploy-registry-certificates.yml,3,0,0,0,0,0,3
2019-03-09 02:12:10.233166, /home/brokenquark/repo-ansi/openshift@openshift-ansible-contrib/playbooks/aws/openshift-cluster/vars.yml,2,0,0,0,0,0,2
2019-03-09 02:12:10.323647, /home/brokenquark/repo-ansi/openshift@openshift-ansible-contrib/playbooks/provisioning/openstack/post-provision-openstack.yml,1,0,0,0,0,0,1
2019-03-09 02:12:10.352287, /home/brokenquark/repo-ansi/openshift@openshift-ansible-contrib/playbooks/provisioning/openstack/post-install.yml,0,0,0,0,1,0,1
2019-03-09 02:12:10.394387, /home/brokenquark/repo-ansi/openshift@openshift-ansible-contrib/playbooks/provisioning/openstack/sample-inventory/group_vars/OSEv3.yml,0,0,0,0,2,0,2
2019-03-09 02:12:10.401270, /home/brokenquark/repo-ansi/openshift@openshift-ansible-contrib/playbooks/provisioning/openstack/sample-inventory/group_vars/all.yml,3,0,0,0,1,0,4
2019-03-09 02:12:10.424800, /home/brokenquark/repo-ansi/openshift@openshift-ansible-contrib/playbooks/openstack/openshift-cluster/vars.yml,2,0,0,0,0,0,2
2019-03-09 02:12:10.479137, /home/brokenquark/repo-ansi/openshift@openshift-ansible-contrib/playbooks/openstack/openshift-cluster/files/heat_stack_server.yaml,2,0,0,0,0,0,2
2019-03-09 02:12:10.548320, /home/brokenquark/repo-ansi/openshift@openshift-ansible-contrib/playbooks/openstack/openshift-cluster/files/heat_stack.yaml,0,0,0,2,0,0,2
2019-03-09 02:12:10.564351, /home/brokenquark/repo-ansi/openshift@openshift-ansible-contrib/playbooks/libvirt/openshift-cluster/vars.yml,2,0,0,0,0,0,2
2019-03-09 02:12:10.731754, /home/brokenquark/repo-ansi/openshift@openshift-ansible-contrib/reference-architecture/gcp/ansible/playbooks/roles/gold-image-instance/tasks/main.yaml,1,0,0,0,0,0,1
2019-03-09 02:12:10.747760, /home/brokenquark/repo-ansi/openshift@openshift-ansible-contrib/reference-architecture/gcp/ansible/playbooks/roles/gcp-ssh-key/defaults/main.yaml,2,0,0,0,0,0,2
2019-03-09 02:12:10.789002, /home/brokenquark/repo-ansi/openshift@openshift-ansible-contrib/reference-architecture/gcp/ansible/playbooks/roles/wait-for-instance/tasks/main.yaml,0,0,0,0,2,0,2
2019-03-09 02:12:10.802532, /home/brokenquark/repo-ansi/openshift@openshift-ansible-contrib/reference-architecture/gcp/ansible/playbooks/roles/ssl-certificate-delete/defaults/main.yaml,1,0,0,0,0,0,1
2019-03-09 02:12:10.809835, /home/brokenquark/repo-ansi/openshift@openshift-ansible-contrib/reference-architecture/gcp/ansible/playbooks/roles/ssl-certificate/defaults/main.yaml,1,0,0,0,0,0,1
2019-03-09 02:12:10.820865, /home/brokenquark/repo-ansi/openshift@openshift-ansible-contrib/reference-architecture/gcp/ansible/playbooks/roles/ssl-certificate/tasks/main.yaml,2,0,0,0,0,0,2
2019-03-09 02:12:10.857659, /home/brokenquark/repo-ansi/openshift@openshift-ansible-contrib/reference-architecture/3.9/playbooks/vars/main.yaml,2,0,0,0,0,0,2
2019-03-09 02:12:11.027772, /home/brokenquark/repo-ansi/openshift@openshift-ansible-contrib/reference-architecture/3.9/playbooks/roles/aws/tasks/routetablerule.yaml,0,0,0,1,0,0,1
2019-03-09 02:12:11.067574, /home/brokenquark/repo-ansi/openshift@openshift-ansible-contrib/reference-architecture/azure-ansible/3.5/ansibledeployocp/playbooks/roles/azure-deploy/tasks/main.yaml,0,3,0,0,0,0,3
2019-03-09 02:12:11.072815, /home/brokenquark/repo-ansi/openshift@openshift-ansible-contrib/reference-architecture/azure-ansible/3.5/ansibledeployocp/playbooks/roles/prepare/tasks/main.yaml,0,0,0,0,0,1,1
2019-03-09 02:12:11.087869, /home/brokenquark/repo-ansi/openshift@openshift-ansible-contrib/reference-architecture/azure-ansible/3.6/ansibledeployocp/playbooks/roles/azure-deploy/tasks/main.yaml,0,3,0,0,0,0,3
2019-03-09 02:12:11.093124, /home/brokenquark/repo-ansi/openshift@openshift-ansible-contrib/reference-architecture/azure-ansible/3.6/ansibledeployocp/playbooks/roles/prepare/tasks/main.yaml,0,0,0,0,0,1,1
2019-03-09 02:12:11.101612, /home/brokenquark/repo-ansi/openshift@openshift-ansible-contrib/reference-architecture/vmware-ansible/playbooks/cleanup-crs.yaml,4,0,0,0,0,0,4
2019-03-09 02:12:11.118984, /home/brokenquark/repo-ansi/openshift@openshift-ansible-contrib/reference-architecture/vmware-ansible/playbooks/clean.yaml,1,0,0,0,0,0,1
2019-03-09 02:12:11.149013, /home/brokenquark/repo-ansi/openshift@openshift-ansible-contrib/reference-architecture/vmware-ansible/playbooks/cleanup-cns.yaml,3,0,0,0,0,0,3
2019-03-09 02:12:11.168030, /home/brokenquark/repo-ansi/openshift@openshift-ansible-contrib/reference-architecture/vmware-ansible/playbooks/ocp-install.yaml,1,1,0,0,0,0,2
2019-03-09 02:12:11.172546, /home/brokenquark/repo-ansi/openshift@openshift-ansible-contrib/reference-architecture/vmware-ansible/playbooks/setup.yaml,1,0,0,0,0,0,1
2019-03-09 02:12:11.202574, /home/brokenquark/repo-ansi/openshift@openshift-ansible-contrib/reference-architecture/vmware-ansible/playbooks/roles/heketi-install/tasks/main.yaml,4,0,0,0,0,0,4
2019-03-09 02:12:11.230015, /home/brokenquark/repo-ansi/openshift@openshift-ansible-contrib/reference-architecture/vmware-ansible/playbooks/roles/docker-storage-setup/tasks/main.yaml,2,0,0,0,0,0,2
2019-03-09 02:12:11.247166, /home/brokenquark/repo-ansi/openshift@openshift-ansible-contrib/reference-architecture/vmware-ansible/playbooks/roles/haproxy-server-config/defaults/main.yaml,2,0,0,0,0,0,2
2019-03-09 02:12:11.299014, /home/brokenquark/repo-ansi/openshift@openshift-ansible-contrib/reference-architecture/vmware-ansible/playbooks/roles/haproxy-server/defaults/main.yaml,2,0,0,0,0,0,2
2019-03-09 02:12:11.305518, /home/brokenquark/repo-ansi/openshift@openshift-ansible-contrib/reference-architecture/vmware-ansible/playbooks/roles/cloud-provider-setup/tasks/main.yaml,1,0,0,0,0,0,1
2019-03-09 02:12:11.482049, /home/brokenquark/repo-ansi/openshift@openshift-ansible-contrib/reference-architecture/aws-ansible/playbooks/openshift-setup.yaml,1,0,0,0,0,0,1
2019-03-09 02:12:11.502510, /home/brokenquark/repo-ansi/openshift@openshift-ansible-contrib/reference-architecture/aws-ansible/playbooks/roles/non-atomic-docker-storage-setup/tasks/main.yaml,2,0,0,0,0,0,2
2019-03-09 02:12:11.575044, /home/brokenquark/repo-ansi/openshift@openshift-ansible-contrib/reference-architecture/aws-ansible/playbooks/roles/cloudformation-infra/files/user_data_bastion.yml,1,0,0,0,0,0,1
2019-03-09 02:12:11.578996, /home/brokenquark/repo-ansi/openshift@openshift-ansible-contrib/reference-architecture/aws-ansible/playbooks/roles/cloudformation-infra/files/user_data_master.yml,2,0,0,0,0,0,2
2019-03-09 02:12:11.582028, /home/brokenquark/repo-ansi/openshift@openshift-ansible-contrib/reference-architecture/aws-ansible/playbooks/roles/cloudformation-infra/files/user_data_node.yml,2,0,0,0,0,0,2
2019-03-09 02:12:11.583018, /home/brokenquark/repo-ansi/openshift@openshift-ansible-contrib/reference-architecture/aws-ansible/playbooks/roles/cloudformation-infra/files/user_data_gluster.yml,1,0,0,0,0,0,1
2019-03-09 02:12:16.176534, /home/brokenquark/repo-ansi/openshift@openshift-tools/ansible/playbooks/adhoc/detach_failed_volumes.yml,1,0,0,0,1,0,2
2019-03-09 02:12:16.179830, /home/brokenquark/repo-ansi/openshift@openshift-tools/ansible/playbooks/adhoc/setupnfs.yml,1,0,0,0,0,0,1
2019-03-09 02:12:16.196975, /home/brokenquark/repo-ansi/openshift@openshift-tools/ansible/playbooks/adhoc/os_update.yml,4,0,0,0,0,0,4
2019-03-09 02:12:16.234434, /home/brokenquark/repo-ansi/openshift@openshift-tools/ansible/playbooks/adhoc/docker_loopback_to_lvm/ops-docker-loopback-to-direct-lvm.yml,2,0,0,0,0,0,2
2019-03-09 02:12:16.260259, /home/brokenquark/repo-ansi/openshift@openshift-tools/ansible/playbooks/adhoc/metrics_setup/files/metrics.yaml,1,0,0,0,0,0,1
2019-03-09 02:12:16.267168, /home/brokenquark/repo-ansi/openshift@openshift-tools/ansible/playbooks/adhoc/zabbix_setup/clean_zabbix.yml,0,1,0,0,0,0,1
2019-03-09 02:12:16.270504, /home/brokenquark/repo-ansi/openshift@openshift-tools/ansible/playbooks/adhoc/zabbix_setup/oo-config-zaio.yml,1,0,0,0,0,0,1
2019-03-09 02:12:16.309163, /home/brokenquark/repo-ansi/openshift@openshift-tools/ansible/playbooks/adhoc/add_etcd_volume/add_etcd_volume.yml,3,0,0,0,0,0,3
2019-03-09 02:12:16.318452, /home/brokenquark/repo-ansi/openshift@openshift-tools/ansible/playbooks/adhoc/s3_registry/s3_registry.yml,1,0,0,0,0,0,1
2019-03-09 02:12:16.340444, /home/brokenquark/repo-ansi/openshift@openshift-tools/ansible/playbooks/adhoc/grow_docker_vg/grow_docker_vg.yml,1,0,0,0,0,0,1
2019-03-09 02:12:16.345706, /home/brokenquark/repo-ansi/openshift@openshift-tools/ansible/playbooks/adhoc/sdn_restart/oo-sdn-restart.yml,1,0,0,0,0,0,1
2019-03-09 02:12:16.364540, /home/brokenquark/repo-ansi/openshift@openshift-tools/ansible/playbooks/adhoc/create_pv/create_pv.yaml,3,0,0,0,0,0,3
2019-03-09 02:12:16.378244, /home/brokenquark/repo-ansi/openshift@openshift-tools/ansible/playbooks/adhoc/docker_storage_reinitialize/ops-docker-storage-reinitialize.yml,1,0,0,0,0,0,1
2019-03-09 02:12:16.391004, /home/brokenquark/repo-ansi/openshift@openshift-tools/ansible/playbooks/adhoc/grow_root_vg/grow_root_vg-m5-revert.yml,1,0,0,0,0,0,1
2019-03-09 02:12:16.419946, /home/brokenquark/repo-ansi/openshift@openshift-tools/ansible/playbooks/adhoc/grow_root_vg/grow_root_vg-m5.yml,1,0,0,0,0,0,1
2019-03-09 02:12:16.438722, /home/brokenquark/repo-ansi/openshift@openshift-tools/ansible/playbooks/adhoc/grow_root_vg/grow_root_vg.yml,1,0,0,0,0,0,1
2019-03-09 02:12:16.449516, /home/brokenquark/repo-ansi/openshift@openshift-tools/ansible/playbooks/adhoc/hotfix/hotfix.yml,4,0,0,0,2,0,6
2019-03-09 02:12:16.478522, /home/brokenquark/repo-ansi/openshift@openshift-tools/ansible/playbooks/adhoc/noc/create_host.yml,1,0,0,0,0,0,1
2019-03-09 02:12:16.495050, /home/brokenquark/repo-ansi/openshift@openshift-tools/ansible/playbooks/adhoc/docker_storage_cleanup/docker_storage_cleanup.yml,1,0,0,0,1,0,2
2019-03-09 02:12:16.506513, /home/brokenquark/repo-ansi/openshift@openshift-tools/ansible/playbooks/adhoc/docker_storage_to_overlay2/docker_storage_to_overlay2.yml,4,0,0,0,0,0,4
2019-03-09 02:12:16.514059, /home/brokenquark/repo-ansi/openshift@openshift-tools/ansible/playbooks/release/openshift_cluster_post_install_config.yml,3,0,0,0,0,0,3
2019-03-09 02:12:18.804425, /home/brokenquark/repo-ansi/openshift@openshift-tools/openshift/installer/vendored/openshift-ansible-3.10.0-0.29.0/playbooks/common/openshift-cluster/upgrades/pre/verify_cluster.yml,1,0,0,0,0,0,1
2019-03-09 02:12:18.841947, /home/brokenquark/repo-ansi/openshift@openshift-tools/openshift/installer/vendored/openshift-ansible-3.10.0-0.29.0/playbooks/common/openshift-cluster/upgrades/v3_10/upgrade_control_plane.yml,0,0,0,0,1,0,1
2019-03-09 02:12:18.866909, /home/brokenquark/repo-ansi/openshift@openshift-tools/openshift/installer/vendored/openshift-ansible-3.10.0-0.29.0/playbooks/common/openshift-cluster/upgrades/v3_9/upgrade_control_plane.yml,0,0,0,0,1,0,1
2019-03-09 02:12:18.975010, /home/brokenquark/repo-ansi/openshift@openshift-tools/openshift/installer/vendored/openshift-ansible-3.10.0-0.29.0/playbooks/openshift-master/private/redeploy-openshift-ca.yml,9,0,0,0,0,0,9
2019-03-09 02:12:19.013657, /home/brokenquark/repo-ansi/openshift@openshift-tools/openshift/installer/vendored/openshift-ansible-3.10.0-0.29.0/playbooks/openshift-master/private/scaleup.yml,1,0,0,0,0,0,1
2019-03-09 02:12:19.030367, /home/brokenquark/repo-ansi/openshift@openshift-tools/openshift/installer/vendored/openshift-ansible-3.10.0-0.29.0/playbooks/openshift-master/private/revert-client-ca.yml,1,0,0,0,0,0,1
2019-03-09 02:12:19.054436, /home/brokenquark/repo-ansi/openshift@openshift-tools/openshift/installer/vendored/openshift-ansible-3.10.0-0.29.0/playbooks/openshift-master/private/upgrade.yml,0,0,0,0,1,0,1
2019-03-09 02:12:19.063774, /home/brokenquark/repo-ansi/openshift@openshift-tools/openshift/installer/vendored/openshift-ansible-3.10.0-0.29.0/playbooks/openshift-master/private/tasks/restart_hosts.yml,0,0,0,0,1,0,1
2019-03-09 02:12:19.212951, /home/brokenquark/repo-ansi/openshift@openshift-tools/openshift/installer/vendored/openshift-ansible-3.10.0-0.29.0/playbooks/gcp/openshift-cluster/build_base_image.yml,2,0,0,0,0,1,3
2019-03-09 02:12:19.302031, /home/brokenquark/repo-ansi/openshift@openshift-tools/openshift/installer/vendored/openshift-ansible-3.10.0-0.29.0/playbooks/byo/calico/legacy_upgrade.yml,4,0,0,0,0,0,4
2019-03-09 02:12:19.396766, /home/brokenquark/repo-ansi/openshift@openshift-tools/openshift/installer/vendored/openshift-ansible-3.10.0-0.29.0/playbooks/init/version.yml,0,0,0,0,2,0,2
2019-03-09 02:12:19.530085, /home/brokenquark/repo-ansi/openshift@openshift-tools/openshift/installer/vendored/openshift-ansible-3.10.0-0.29.0/playbooks/openshift-hosted/private/redeploy-router-certificates.yml,1,0,0,0,0,0,1
2019-03-09 02:12:19.541472, /home/brokenquark/repo-ansi/openshift@openshift-tools/openshift/installer/vendored/openshift-ansible-3.10.0-0.29.0/playbooks/openshift-hosted/private/redeploy-registry-certificates.yml,3,0,0,0,0,0,3
2019-03-09 02:12:27.920615, /home/brokenquark/repo-ansi/openshift@openshift-tools/openshift/installer/vendored/openshift-ansible-git-2016-04-18/playbooks/common/openshift-master/config.yml,1,0,0,0,0,0,1
2019-03-09 02:12:27.927847, /home/brokenquark/repo-ansi/openshift@openshift-tools/openshift/installer/vendored/openshift-ansible-git-2016-04-18/playbooks/common/openshift-master/scaleup.yml,1,0,0,0,0,0,1
2019-03-09 02:12:28.012808, /home/brokenquark/repo-ansi/openshift@openshift-tools/openshift/installer/vendored/openshift-ansible-git-2016-04-18/playbooks/common/openshift-node/config.yml,1,0,0,0,0,0,1
2019-03-09 02:12:29.446918, /home/brokenquark/repo-ansi/openshift@openshift-tools/openshift/installer/vendored/openshift-ansible-3.8.36-1/playbooks/common/openshift-cluster/upgrades/upgrade_control_plane.yml,0,0,0,0,1,0,1
2019-03-09 02:12:29.511977, /home/brokenquark/repo-ansi/openshift@openshift-tools/openshift/installer/vendored/openshift-ansible-3.8.36-1/playbooks/common/openshift-cluster/upgrades/pre/verify_cluster.yml,1,0,0,0,0,0,1
2019-03-09 02:12:29.532008, /home/brokenquark/repo-ansi/openshift@openshift-tools/openshift/installer/vendored/openshift-ansible-3.8.36-1/playbooks/common/openshift-cluster/upgrades/v3_6/validator.yml,0,0,0,0,1,0,1
2019-03-09 02:12:29.570004, /home/brokenquark/repo-ansi/openshift@openshift-tools/openshift/installer/vendored/openshift-ansible-3.8.36-1/playbooks/common/openshift-cluster/upgrades/v3_9/upgrade_control_plane.yml,0,0,0,0,1,0,1
2019-03-09 02:12:29.586310, /home/brokenquark/repo-ansi/openshift@openshift-tools/openshift/installer/vendored/openshift-ansible-3.8.36-1/playbooks/common/openshift-cluster/upgrades/v3_7/validator.yml,0,0,0,0,1,0,1
2019-03-09 02:12:29.615779, /home/brokenquark/repo-ansi/openshift@openshift-tools/openshift/installer/vendored/openshift-ansible-3.8.36-1/playbooks/common/openshift-cluster/upgrades/v3_8/master_config_upgrade.yml,4,0,0,0,0,0,4
2019-03-09 02:12:29.723827, /home/brokenquark/repo-ansi/openshift@openshift-tools/openshift/installer/vendored/openshift-ansible-3.8.36-1/playbooks/openshift-master/private/redeploy-openshift-ca.yml,9,0,0,0,0,0,9
2019-03-09 02:12:29.779793, /home/brokenquark/repo-ansi/openshift@openshift-tools/openshift/installer/vendored/openshift-ansible-3.8.36-1/playbooks/openshift-master/private/scaleup.yml,1,0,0,0,0,0,1
2019-03-09 02:12:29.787141, /home/brokenquark/repo-ansi/openshift@openshift-tools/openshift/installer/vendored/openshift-ansible-3.8.36-1/playbooks/openshift-master/private/revert-client-ca.yml,1,0,0,0,0,0,1
2019-03-09 02:12:29.826130, /home/brokenquark/repo-ansi/openshift@openshift-tools/openshift/installer/vendored/openshift-ansible-3.8.36-1/playbooks/openshift-master/private/tasks/wire_aggregator.yml,12,0,0,0,1,0,13
2019-03-09 02:12:29.830292, /home/brokenquark/repo-ansi/openshift@openshift-tools/openshift/installer/vendored/openshift-ansible-3.8.36-1/playbooks/openshift-master/private/tasks/restart_hosts.yml,0,0,0,0,2,0,2
2019-03-09 02:12:29.993527, /home/brokenquark/repo-ansi/openshift@openshift-tools/openshift/installer/vendored/openshift-ansible-3.8.36-1/playbooks/gcp/openshift-cluster/build_base_image.yml,2,0,0,0,0,1,3
2019-03-09 02:12:30.148341, /home/brokenquark/repo-ansi/openshift@openshift-tools/openshift/installer/vendored/openshift-ansible-3.8.36-1/playbooks/init/version.yml,0,0,0,0,2,0,2
2019-03-09 02:12:30.282173, /home/brokenquark/repo-ansi/openshift@openshift-tools/openshift/installer/vendored/openshift-ansible-3.8.36-1/playbooks/openshift-hosted/private/redeploy-router-certificates.yml,1,0,0,0,0,0,1
2019-03-09 02:12:30.294690, /home/brokenquark/repo-ansi/openshift@openshift-tools/openshift/installer/vendored/openshift-ansible-3.8.36-1/playbooks/openshift-hosted/private/redeploy-registry-certificates.yml,3,0,0,0,0,0,3
2019-03-09 02:12:37.488284, /home/brokenquark/repo-ansi/openshift@openshift-tools/openshift/installer/vendored/openshift-ansible-3.9.14-1/playbooks/common/openshift-cluster/upgrades/pre/verify_cluster.yml,1,0,0,0,0,0,1
2019-03-09 02:12:37.511437, /home/brokenquark/repo-ansi/openshift@openshift-tools/openshift/installer/vendored/openshift-ansible-3.9.14-1/playbooks/common/openshift-cluster/upgrades/v3_6/validator.yml,0,0,0,0,1,0,1
2019-03-09 02:12:37.546397, /home/brokenquark/repo-ansi/openshift@openshift-tools/openshift/installer/vendored/openshift-ansible-3.9.14-1/playbooks/common/openshift-cluster/upgrades/v3_9/upgrade_control_plane.yml,0,0,0,0,1,0,1
2019-03-09 02:12:37.554069, /home/brokenquark/repo-ansi/openshift@openshift-tools/openshift/installer/vendored/openshift-ansible-3.9.14-1/playbooks/common/openshift-cluster/upgrades/v3_7/validator.yml,0,0,0,0,1,0,1
2019-03-09 02:12:37.657591, /home/brokenquark/repo-ansi/openshift@openshift-tools/openshift/installer/vendored/openshift-ansible-3.9.14-1/playbooks/aws/openshift-cluster/install.yml,1,0,0,0,0,0,1
2019-03-09 02:12:37.721170, /home/brokenquark/repo-ansi/openshift@openshift-tools/openshift/installer/vendored/openshift-ansible-3.9.14-1/playbooks/openshift-master/private/redeploy-openshift-ca.yml,9,0,0,0,0,0,9
2019-03-09 02:12:37.773911, /home/brokenquark/repo-ansi/openshift@openshift-tools/openshift/installer/vendored/openshift-ansible-3.9.14-1/playbooks/openshift-master/private/scaleup.yml,1,0,0,0,0,0,1
2019-03-09 02:12:37.790647, /home/brokenquark/repo-ansi/openshift@openshift-tools/openshift/installer/vendored/openshift-ansible-3.9.14-1/playbooks/openshift-master/private/revert-client-ca.yml,1,0,0,0,0,0,1
2019-03-09 02:12:37.828658, /home/brokenquark/repo-ansi/openshift@openshift-tools/openshift/installer/vendored/openshift-ansible-3.9.14-1/playbooks/openshift-master/private/upgrade.yml,0,0,0,0,1,0,1
2019-03-09 02:12:37.862014, /home/brokenquark/repo-ansi/openshift@openshift-tools/openshift/installer/vendored/openshift-ansible-3.9.14-1/playbooks/openshift-master/private/tasks/wire_aggregator.yml,12,0,0,0,1,0,13
2019-03-09 02:12:37.864784, /home/brokenquark/repo-ansi/openshift@openshift-tools/openshift/installer/vendored/openshift-ansible-3.9.14-1/playbooks/openshift-master/private/tasks/restart_hosts.yml,0,0,0,0,1,0,1
2019-03-09 02:12:38.032345, /home/brokenquark/repo-ansi/openshift@openshift-tools/openshift/installer/vendored/openshift-ansible-3.9.14-1/playbooks/gcp/openshift-cluster/build_base_image.yml,2,0,0,0,0,1,3
2019-03-09 02:12:38.175492, /home/brokenquark/repo-ansi/openshift@openshift-tools/openshift/installer/vendored/openshift-ansible-3.9.14-1/playbooks/init/version.yml,0,0,0,0,2,0,2
2019-03-09 02:12:38.312658, /home/brokenquark/repo-ansi/openshift@openshift-tools/openshift/installer/vendored/openshift-ansible-3.9.14-1/playbooks/openshift-hosted/private/redeploy-router-certificates.yml,1,0,0,0,0,0,1
2019-03-09 02:12:38.324354, /home/brokenquark/repo-ansi/openshift@openshift-tools/openshift/installer/vendored/openshift-ansible-3.9.14-1/playbooks/openshift-hosted/private/redeploy-registry-certificates.yml,3,0,0,0,0,0,3
2019-03-09 02:12:45.625206, /home/brokenquark/repo-ansi/openshift@openshift-tools/openshift/installer/vendored/openshift-ansible-3.0.47/playbooks/common/openshift-master/config.yml,1,0,0,0,0,0,1
2019-03-09 02:12:45.724120, /home/brokenquark/repo-ansi/openshift@openshift-tools/openshift/installer/vendored/openshift-ansible-3.0.47/playbooks/common/openshift-node/config.yml,1,0,0,0,0,0,1
2019-03-09 02:12:46.500582, /home/brokenquark/repo-ansi/openshift@openshift-tools/openshift/installer/vendored/openshift-ansible-3.4.12-1/playbooks/common/openshift-master/scaleup.yml,1,0,0,0,0,0,1
2019-03-09 02:12:46.559512, /home/brokenquark/repo-ansi/openshift@openshift-tools/openshift/installer/vendored/openshift-ansible-3.4.12-1/playbooks/common/openshift-cluster/initialize_openshift_version.yml,0,0,0,0,2,0,2
2019-03-09 02:12:46.637852, /home/brokenquark/repo-ansi/openshift@openshift-tools/openshift/installer/vendored/openshift-ansible-3.4.12-1/playbooks/common/openshift-cluster/enable_dnsmasq.yml,2,0,0,0,0,0,2
2019-03-09 02:12:46.776045, /home/brokenquark/repo-ansi/openshift@openshift-tools/openshift/installer/vendored/openshift-ansible-3.4.12-1/playbooks/common/openshift-cluster/upgrades/v3_3/node_config_upgrade.yml,4,0,0,0,0,0,4
2019-03-09 02:12:46.782522, /home/brokenquark/repo-ansi/openshift@openshift-tools/openshift/installer/vendored/openshift-ansible-3.4.12-1/playbooks/common/openshift-cluster/upgrades/v3_3/master_config_upgrade.yml,10,0,0,0,0,0,10
2019-03-09 02:12:48.233821, /home/brokenquark/repo-ansi/openshift@openshift-tools/openshift/installer/vendored/openshift-ansible-3.3.46/playbooks/common/openshift-master/scaleup.yml,1,0,0,0,0,0,1
2019-03-09 02:12:48.305494, /home/brokenquark/repo-ansi/openshift@openshift-tools/openshift/installer/vendored/openshift-ansible-3.3.46/playbooks/common/openshift-cluster/initialize_openshift_version.yml,0,0,0,0,2,0,2
2019-03-09 02:12:48.391085, /home/brokenquark/repo-ansi/openshift@openshift-tools/openshift/installer/vendored/openshift-ansible-3.3.46/playbooks/common/openshift-cluster/enable_dnsmasq.yml,2,0,0,0,0,0,2
2019-03-09 02:12:48.509372, /home/brokenquark/repo-ansi/openshift@openshift-tools/openshift/installer/vendored/openshift-ansible-3.3.46/playbooks/common/openshift-cluster/upgrades/v3_3/node_config_upgrade.yml,4,0,0,0,0,0,4
2019-03-09 02:12:48.516655, /home/brokenquark/repo-ansi/openshift@openshift-tools/openshift/installer/vendored/openshift-ansible-3.3.46/playbooks/common/openshift-cluster/upgrades/v3_3/master_config_upgrade.yml,10,0,0,0,0,0,10
2019-03-09 02:12:49.956539, /home/brokenquark/repo-ansi/openshift@openshift-tools/openshift/installer/vendored/openshift-ansible-3.0.88/playbooks/common/openshift-master/config.yml,1,0,0,0,0,0,1
2019-03-09 02:12:49.963351, /home/brokenquark/repo-ansi/openshift@openshift-tools/openshift/installer/vendored/openshift-ansible-3.0.88/playbooks/common/openshift-master/scaleup.yml,1,0,0,0,0,0,1
2019-03-09 02:12:50.049945, /home/brokenquark/repo-ansi/openshift@openshift-tools/openshift/installer/vendored/openshift-ansible-3.0.88/playbooks/common/openshift-node/config.yml,1,0,0,0,0,0,1
2019-03-09 02:12:51.158280, /home/brokenquark/repo-ansi/openshift@openshift-tools/openshift/installer/vendored/openshift-ansible-3.2.24/playbooks/common/openshift-master/scaleup.yml,1,0,0,0,0,0,1
2019-03-09 02:12:51.230390, /home/brokenquark/repo-ansi/openshift@openshift-tools/openshift/installer/vendored/openshift-ansible-3.2.24/playbooks/common/openshift-cluster/initialize_openshift_version.yml,0,0,0,0,2,0,2
2019-03-09 02:12:51.305260, /home/brokenquark/repo-ansi/openshift@openshift-tools/openshift/installer/vendored/openshift-ansible-3.2.24/playbooks/common/openshift-cluster/enable_dnsmasq.yml,2,0,0,0,0,0,2
2019-03-09 02:12:51.405183, /home/brokenquark/repo-ansi/openshift@openshift-tools/openshift/installer/vendored/openshift-ansible-3.2.24/playbooks/common/openshift-cluster/upgrades/v3_3/node_config_upgrade.yml,4,0,0,0,0,0,4
2019-03-09 02:12:51.410531, /home/brokenquark/repo-ansi/openshift@openshift-tools/openshift/installer/vendored/openshift-ansible-3.2.24/playbooks/common/openshift-cluster/upgrades/v3_3/master_config_upgrade.yml,8,0,0,0,0,0,8
2019-03-09 02:12:52.552876, /home/brokenquark/repo-ansi/openshift@openshift-tools/openshift/installer/vendored/openshift-ansible-3.5.127/playbooks/common/openshift-master/scaleup.yml,1,0,0,0,0,0,1
2019-03-09 02:12:52.558772, /home/brokenquark/repo-ansi/openshift@openshift-tools/openshift/installer/vendored/openshift-ansible-3.5.127/playbooks/common/openshift-master/restart_hosts.yml,0,0,0,0,2,0,2
2019-03-09 02:12:52.616181, /home/brokenquark/repo-ansi/openshift@openshift-tools/openshift/installer/vendored/openshift-ansible-3.5.127/playbooks/common/openshift-cluster/initialize_openshift_version.yml,0,0,0,0,2,0,2
2019-03-09 02:12:52.670932, /home/brokenquark/repo-ansi/openshift@openshift-tools/openshift/installer/vendored/openshift-ansible-3.5.127/playbooks/common/openshift-cluster/enable_dnsmasq.yml,2,0,0,0,0,0,2
2019-03-09 02:12:52.703451, /home/brokenquark/repo-ansi/openshift@openshift-tools/openshift/installer/vendored/openshift-ansible-3.5.127/playbooks/common/openshift-cluster/redeploy-certificates/registry.yml,3,0,0,0,0,0,3
2019-03-09 02:12:52.756876, /home/brokenquark/repo-ansi/openshift@openshift-tools/openshift/installer/vendored/openshift-ansible-3.5.127/playbooks/common/openshift-cluster/redeploy-certificates/openshift-ca.yml,9,0,0,0,0,0,9
2019-03-09 02:12:52.784905, /home/brokenquark/repo-ansi/openshift@openshift-tools/openshift/installer/vendored/openshift-ansible-3.5.127/playbooks/common/openshift-cluster/redeploy-certificates/router.yml,1,0,0,0,0,0,1
2019-03-09 02:12:52.804349, /home/brokenquark/repo-ansi/openshift@openshift-tools/openshift/installer/vendored/openshift-ansible-3.5.127/playbooks/common/openshift-cluster/upgrades/rpm_upgrade.yml,0,0,0,0,1,0,1
2019-03-09 02:12:52.806441, /home/brokenquark/repo-ansi/openshift@openshift-tools/openshift/installer/vendored/openshift-ansible-3.5.127/playbooks/common/openshift-cluster/upgrades/containerized_node_upgrade.yml,0,0,0,0,1,0,1
2019-03-09 02:12:52.849308, /home/brokenquark/repo-ansi/openshift@openshift-tools/openshift/installer/vendored/openshift-ansible-3.5.127/playbooks/common/openshift-cluster/upgrades/upgrade_control_plane.yml,0,0,0,0,1,0,1
2019-03-09 02:12:52.933036, /home/brokenquark/repo-ansi/openshift@openshift-tools/openshift/installer/vendored/openshift-ansible-3.5.127/playbooks/common/openshift-cluster/upgrades/v3_4/master_config_upgrade.yml,3,0,0,0,0,0,3
2019-03-09 02:12:52.969453, /home/brokenquark/repo-ansi/openshift@openshift-tools/openshift/installer/vendored/openshift-ansible-3.5.127/playbooks/common/openshift-cluster/upgrades/v3_5/validator.yml,0,0,0,0,4,0,4
2019-03-09 02:12:53.051128, /home/brokenquark/repo-ansi/openshift@openshift-tools/openshift/installer/vendored/openshift-ansible-3.5.127/playbooks/common/openshift-cluster/upgrades/v3_3/node_config_upgrade.yml,4,0,0,0,0,0,4
2019-03-09 02:12:53.058911, /home/brokenquark/repo-ansi/openshift@openshift-tools/openshift/installer/vendored/openshift-ansible-3.5.127/playbooks/common/openshift-cluster/upgrades/v3_3/master_config_upgrade.yml,13,0,0,0,0,0,13
2019-03-09 02:12:55.959320, /home/brokenquark/repo-ansi/openshift@openshift-tools/openshift/installer/vendored/openshift-ansible-3.6.173.0.59/playbooks/common/openshift-master/scaleup.yml,1,0,0,0,0,0,1
2019-03-09 02:12:55.965360, /home/brokenquark/repo-ansi/openshift@openshift-tools/openshift/installer/vendored/openshift-ansible-3.6.173.0.59/playbooks/common/openshift-master/restart_hosts.yml,0,0,0,0,2,0,2
2019-03-09 02:12:56.069709, /home/brokenquark/repo-ansi/openshift@openshift-tools/openshift/installer/vendored/openshift-ansible-3.6.173.0.59/playbooks/common/openshift-cluster/initialize_openshift_version.yml,0,0,0,0,2,0,2
2019-03-09 02:12:56.134852, /home/brokenquark/repo-ansi/openshift@openshift-tools/openshift/installer/vendored/openshift-ansible-3.6.173.0.59/playbooks/common/openshift-cluster/enable_dnsmasq.yml,2,0,0,0,0,0,2
2019-03-09 02:12:56.159379, /home/brokenquark/repo-ansi/openshift@openshift-tools/openshift/installer/vendored/openshift-ansible-3.6.173.0.59/playbooks/common/openshift-cluster/redeploy-certificates/masters.yml,1,0,0,0,0,0,1
2019-03-09 02:12:56.169916, /home/brokenquark/repo-ansi/openshift@openshift-tools/openshift/installer/vendored/openshift-ansible-3.6.173.0.59/playbooks/common/openshift-cluster/redeploy-certificates/registry.yml,3,0,0,0,0,0,3
2019-03-09 02:12:56.224552, /home/brokenquark/repo-ansi/openshift@openshift-tools/openshift/installer/vendored/openshift-ansible-3.6.173.0.59/playbooks/common/openshift-cluster/redeploy-certificates/openshift-ca.yml,9,0,0,0,0,0,9
2019-03-09 02:12:56.252382, /home/brokenquark/repo-ansi/openshift@openshift-tools/openshift/installer/vendored/openshift-ansible-3.6.173.0.59/playbooks/common/openshift-cluster/redeploy-certificates/router.yml,1,0,0,0,0,0,1
2019-03-09 02:12:56.268283, /home/brokenquark/repo-ansi/openshift@openshift-tools/openshift/installer/vendored/openshift-ansible-3.6.173.0.59/playbooks/common/openshift-cluster/upgrades/rpm_upgrade.yml,0,0,0,0,1,0,1
2019-03-09 02:12:56.269786, /home/brokenquark/repo-ansi/openshift@openshift-tools/openshift/installer/vendored/openshift-ansible-3.6.173.0.59/playbooks/common/openshift-cluster/upgrades/containerized_node_upgrade.yml,0,0,0,0,1,0,1
2019-03-09 02:12:56.322299, /home/brokenquark/repo-ansi/openshift@openshift-tools/openshift/installer/vendored/openshift-ansible-3.6.173.0.59/playbooks/common/openshift-cluster/upgrades/upgrade_control_plane.yml,1,0,0,0,2,0,3
2019-03-09 02:12:56.422728, /home/brokenquark/repo-ansi/openshift@openshift-tools/openshift/installer/vendored/openshift-ansible-3.6.173.0.59/playbooks/common/openshift-cluster/upgrades/v3_4/master_config_upgrade.yml,5,0,0,0,0,0,5
2019-03-09 02:12:56.460564, /home/brokenquark/repo-ansi/openshift@openshift-tools/openshift/installer/vendored/openshift-ansible-3.6.173.0.59/playbooks/common/openshift-cluster/upgrades/v3_5/validator.yml,0,0,0,0,4,0,4
2019-03-09 02:12:56.464383, /home/brokenquark/repo-ansi/openshift@openshift-tools/openshift/installer/vendored/openshift-ansible-3.6.173.0.59/playbooks/common/openshift-cluster/upgrades/v3_5/master_config_upgrade.yml,5,0,0,0,0,0,5
2019-03-09 02:12:56.497547, /home/brokenquark/repo-ansi/openshift@openshift-tools/openshift/installer/vendored/openshift-ansible-3.6.173.0.59/playbooks/common/openshift-cluster/upgrades/v3_6/validator.yml,0,0,0,0,1,0,1
2019-03-09 02:12:56.500600, /home/brokenquark/repo-ansi/openshift@openshift-tools/openshift/installer/vendored/openshift-ansible-3.6.173.0.59/playbooks/common/openshift-cluster/upgrades/v3_6/master_config_upgrade.yml,5,0,0,0,0,0,5
2019-03-09 02:12:56.555918, /home/brokenquark/repo-ansi/openshift@openshift-tools/openshift/installer/vendored/openshift-ansible-3.6.173.0.59/playbooks/common/openshift-cluster/upgrades/v3_3/node_config_upgrade.yml,4,0,0,0,0,0,4
2019-03-09 02:12:56.563966, /home/brokenquark/repo-ansi/openshift@openshift-tools/openshift/installer/vendored/openshift-ansible-3.6.173.0.59/playbooks/common/openshift-cluster/upgrades/v3_3/master_config_upgrade.yml,13,0,0,0,0,0,13
2019-03-09 02:13:00.516848, /home/brokenquark/repo-ansi/openshift@openshift-tools/openshift/installer/vendored/openshift-ansible-3.7.52-1/playbooks/common/openshift-master/scaleup.yml,1,0,0,0,0,0,1
2019-03-09 02:13:00.521384, /home/brokenquark/repo-ansi/openshift@openshift-tools/openshift/installer/vendored/openshift-ansible-3.7.52-1/playbooks/common/openshift-master/restart_hosts.yml,0,0,0,0,1,0,1
2019-03-09 02:13:00.526276, /home/brokenquark/repo-ansi/openshift@openshift-tools/openshift/installer/vendored/openshift-ansible-3.7.52-1/playbooks/common/openshift-master/revert-client-ca.yml,1,0,0,0,0,0,1
2019-03-09 02:13:00.560556, /home/brokenquark/repo-ansi/openshift@openshift-tools/openshift/installer/vendored/openshift-ansible-3.7.52-1/playbooks/common/openshift-master/tasks/wire_aggregator.yml,12,0,0,0,1,0,13
2019-03-09 02:13:00.726923, /home/brokenquark/repo-ansi/openshift@openshift-tools/openshift/installer/vendored/openshift-ansible-3.7.52-1/playbooks/common/openshift-cluster/initialize_openshift_version.yml,0,0,0,0,2,0,2
2019-03-09 02:13:00.810996, /home/brokenquark/repo-ansi/openshift@openshift-tools/openshift/installer/vendored/openshift-ansible-3.7.52-1/playbooks/common/openshift-cluster/enable_dnsmasq.yml,2,0,0,0,0,0,2
2019-03-09 02:13:00.863121, /home/brokenquark/repo-ansi/openshift@openshift-tools/openshift/installer/vendored/openshift-ansible-3.7.52-1/playbooks/common/openshift-cluster/redeploy-certificates/registry.yml,3,0,0,0,0,0,3
2019-03-09 02:13:00.910148, /home/brokenquark/repo-ansi/openshift@openshift-tools/openshift/installer/vendored/openshift-ansible-3.7.52-1/playbooks/common/openshift-cluster/redeploy-certificates/openshift-ca.yml,9,0,0,0,0,0,9
2019-03-09 02:13:00.929713, /home/brokenquark/repo-ansi/openshift@openshift-tools/openshift/installer/vendored/openshift-ansible-3.7.52-1/playbooks/common/openshift-cluster/redeploy-certificates/router.yml,1,0,0,0,0,0,1
2019-03-09 02:13:01.017434, /home/brokenquark/repo-ansi/openshift@openshift-tools/openshift/installer/vendored/openshift-ansible-3.7.52-1/playbooks/common/openshift-cluster/upgrades/upgrade_control_plane.yml,1,0,0,0,2,0,3
2019-03-09 02:13:01.117089, /home/brokenquark/repo-ansi/openshift@openshift-tools/openshift/installer/vendored/openshift-ansible-3.7.52-1/playbooks/common/openshift-cluster/upgrades/pre/verify_etcd3_backend.yml,1,0,0,0,0,0,1
2019-03-09 02:13:01.125798, /home/brokenquark/repo-ansi/openshift@openshift-tools/openshift/installer/vendored/openshift-ansible-3.7.52-1/playbooks/common/openshift-cluster/upgrades/v3_4/master_config_upgrade.yml,2,0,0,0,0,0,2
2019-03-09 02:13:01.167359, /home/brokenquark/repo-ansi/openshift@openshift-tools/openshift/installer/vendored/openshift-ansible-3.7.52-1/playbooks/common/openshift-cluster/upgrades/v3_5/validator.yml,0,0,0,0,4,0,4
2019-03-09 02:13:01.168807, /home/brokenquark/repo-ansi/openshift@openshift-tools/openshift/installer/vendored/openshift-ansible-3.7.52-1/playbooks/common/openshift-cluster/upgrades/v3_5/master_config_upgrade.yml,2,0,0,0,0,0,2
2019-03-09 02:13:01.203393, /home/brokenquark/repo-ansi/openshift@openshift-tools/openshift/installer/vendored/openshift-ansible-3.7.52-1/playbooks/common/openshift-cluster/upgrades/v3_6/validator.yml,0,0,0,0,1,0,1
2019-03-09 02:13:01.205343, /home/brokenquark/repo-ansi/openshift@openshift-tools/openshift/installer/vendored/openshift-ansible-3.7.52-1/playbooks/common/openshift-cluster/upgrades/v3_6/master_config_upgrade.yml,3,0,0,0,0,0,3
2019-03-09 02:13:01.266614, /home/brokenquark/repo-ansi/openshift@openshift-tools/openshift/installer/vendored/openshift-ansible-3.7.52-1/playbooks/common/openshift-cluster/upgrades/v3_3/node_config_upgrade.yml,4,0,0,0,0,0,4
2019-03-09 02:13:01.274414, /home/brokenquark/repo-ansi/openshift@openshift-tools/openshift/installer/vendored/openshift-ansible-3.7.52-1/playbooks/common/openshift-cluster/upgrades/v3_3/master_config_upgrade.yml,13,0,0,0,0,0,13
2019-03-09 02:13:01.309540, /home/brokenquark/repo-ansi/openshift@openshift-tools/openshift/installer/vendored/openshift-ansible-3.7.52-1/playbooks/common/openshift-cluster/upgrades/v3_7/validator.yml,0,0,0,0,1,0,1
2019-03-09 02:13:01.312089, /home/brokenquark/repo-ansi/openshift@openshift-tools/openshift/installer/vendored/openshift-ansible-3.7.52-1/playbooks/common/openshift-cluster/upgrades/v3_7/master_config_upgrade.yml,4,0,0,0,0,0,4
2019-03-09 02:13:01.378157, /home/brokenquark/repo-ansi/openshift@openshift-tools/openshift/installer/vendored/openshift-ansible-3.7.52-1/playbooks/aws/openshift-cluster/accept.yml,1,0,0,0,0,0,1
2019-03-09 02:13:01.385808, /home/brokenquark/repo-ansi/openshift@openshift-tools/openshift/installer/vendored/openshift-ansible-3.7.52-1/playbooks/aws/openshift-cluster/install.yml,1,0,0,0,0,0,1
2019-03-09 02:13:07.261993, /home/brokenquark/repo-ansi/openshift@openshift-tools/openshift/installer/vendored/openshift-ansible-git-2016-04-27/playbooks/common/openshift-master/config.yml,1,0,0,0,0,0,1
2019-03-09 02:13:07.268903, /home/brokenquark/repo-ansi/openshift@openshift-tools/openshift/installer/vendored/openshift-ansible-git-2016-04-27/playbooks/common/openshift-master/scaleup.yml,1,0,0,0,0,0,1
2019-03-09 02:13:07.356737, /home/brokenquark/repo-ansi/openshift@openshift-tools/openshift/installer/vendored/openshift-ansible-git-2016-04-27/playbooks/common/openshift-node/config.yml,1,0,0,0,0,0,1
2019-03-09 02:13:08.447417, /home/brokenquark/repo-ansi/openshift@openshift-tools/openshift/installer/vendored/openshift-ansible-3.2.13/playbooks/common/openshift-master/config.yml,1,0,0,0,0,0,1
2019-03-09 02:13:08.454238, /home/brokenquark/repo-ansi/openshift@openshift-tools/openshift/installer/vendored/openshift-ansible-3.2.13/playbooks/common/openshift-master/scaleup.yml,1,0,0,0,0,0,1
2019-03-09 02:13:08.537232, /home/brokenquark/repo-ansi/openshift@openshift-tools/openshift/installer/vendored/openshift-ansible-3.2.13/playbooks/common/openshift-node/config.yml,1,0,0,0,0,0,1
2019-03-09 02:13:08.548542, /home/brokenquark/repo-ansi/openshift@openshift-tools/openshift/installer/vendored/openshift-ansible-3.2.13/playbooks/common/openshift-cluster/initialize_openshift_version.yml,0,0,0,0,2,0,2
2019-03-09 02:13:08.584778, /home/brokenquark/repo-ansi/openshift@openshift-tools/openshift/installer/vendored/openshift-ansible-3.2.13/playbooks/common/openshift-cluster/enable_dnsmasq.yml,2,0,0,0,0,0,2
2019-03-09 02:13:09.802299, /home/brokenquark/repo-ansi/openshift@openshift-tools/openshift/installer/vendored/openshift-ansible-3.7.42-1/playbooks/common/openshift-master/scaleup.yml,1,0,0,0,0,0,1
2019-03-09 02:13:09.806864, /home/brokenquark/repo-ansi/openshift@openshift-tools/openshift/installer/vendored/openshift-ansible-3.7.42-1/playbooks/common/openshift-master/restart_hosts.yml,0,0,0,0,1,0,1
2019-03-09 02:13:09.812581, /home/brokenquark/repo-ansi/openshift@openshift-tools/openshift/installer/vendored/openshift-ansible-3.7.42-1/playbooks/common/openshift-master/revert-client-ca.yml,1,0,0,0,0,0,1
2019-03-09 02:13:09.847134, /home/brokenquark/repo-ansi/openshift@openshift-tools/openshift/installer/vendored/openshift-ansible-3.7.42-1/playbooks/common/openshift-master/tasks/wire_aggregator.yml,12,0,0,0,1,0,13
2019-03-09 02:13:10.011958, /home/brokenquark/repo-ansi/openshift@openshift-tools/openshift/installer/vendored/openshift-ansible-3.7.42-1/playbooks/common/openshift-cluster/initialize_openshift_version.yml,0,0,0,0,2,0,2
2019-03-09 02:13:10.093918, /home/brokenquark/repo-ansi/openshift@openshift-tools/openshift/installer/vendored/openshift-ansible-3.7.42-1/playbooks/common/openshift-cluster/enable_dnsmasq.yml,2,0,0,0,0,0,2
2019-03-09 02:13:10.148257, /home/brokenquark/repo-ansi/openshift@openshift-tools/openshift/installer/vendored/openshift-ansible-3.7.42-1/playbooks/common/openshift-cluster/redeploy-certificates/registry.yml,3,0,0,0,0,0,3
2019-03-09 02:13:10.199740, /home/brokenquark/repo-ansi/openshift@openshift-tools/openshift/installer/vendored/openshift-ansible-3.7.42-1/playbooks/common/openshift-cluster/redeploy-certificates/openshift-ca.yml,9,0,0,0,0,0,9
2019-03-09 02:13:10.220876, /home/brokenquark/repo-ansi/openshift@openshift-tools/openshift/installer/vendored/openshift-ansible-3.7.42-1/playbooks/common/openshift-cluster/redeploy-certificates/router.yml,1,0,0,0,0,0,1
2019-03-09 02:13:10.301654, /home/brokenquark/repo-ansi/openshift@openshift-tools/openshift/installer/vendored/openshift-ansible-3.7.42-1/playbooks/common/openshift-cluster/upgrades/upgrade_control_plane.yml,1,0,0,0,2,0,3
2019-03-09 02:13:10.392742, /home/brokenquark/repo-ansi/openshift@openshift-tools/openshift/installer/vendored/openshift-ansible-3.7.42-1/playbooks/common/openshift-cluster/upgrades/pre/verify_etcd3_backend.yml,1,0,0,0,0,0,1
2019-03-09 02:13:10.401399, /home/brokenquark/repo-ansi/openshift@openshift-tools/openshift/installer/vendored/openshift-ansible-3.7.42-1/playbooks/common/openshift-cluster/upgrades/v3_4/master_config_upgrade.yml,2,0,0,0,0,0,2
2019-03-09 02:13:10.441628, /home/brokenquark/repo-ansi/openshift@openshift-tools/openshift/installer/vendored/openshift-ansible-3.7.42-1/playbooks/common/openshift-cluster/upgrades/v3_5/validator.yml,0,0,0,0,4,0,4
2019-03-09 02:13:10.443124, /home/brokenquark/repo-ansi/openshift@openshift-tools/openshift/installer/vendored/openshift-ansible-3.7.42-1/playbooks/common/openshift-cluster/upgrades/v3_5/master_config_upgrade.yml,2,0,0,0,0,0,2
2019-03-09 02:13:10.481306, /home/brokenquark/repo-ansi/openshift@openshift-tools/openshift/installer/vendored/openshift-ansible-3.7.42-1/playbooks/common/openshift-cluster/upgrades/v3_6/validator.yml,0,0,0,0,1,0,1
2019-03-09 02:13:10.483581, /home/brokenquark/repo-ansi/openshift@openshift-tools/openshift/installer/vendored/openshift-ansible-3.7.42-1/playbooks/common/openshift-cluster/upgrades/v3_6/master_config_upgrade.yml,3,0,0,0,0,0,3
2019-03-09 02:13:10.554349, /home/brokenquark/repo-ansi/openshift@openshift-tools/openshift/installer/vendored/openshift-ansible-3.7.42-1/playbooks/common/openshift-cluster/upgrades/v3_3/node_config_upgrade.yml,4,0,0,0,0,0,4
2019-03-09 02:13:10.562579, /home/brokenquark/repo-ansi/openshift@openshift-tools/openshift/installer/vendored/openshift-ansible-3.7.42-1/playbooks/common/openshift-cluster/upgrades/v3_3/master_config_upgrade.yml,13,0,0,0,0,0,13
2019-03-09 02:13:10.603039, /home/brokenquark/repo-ansi/openshift@openshift-tools/openshift/installer/vendored/openshift-ansible-3.7.42-1/playbooks/common/openshift-cluster/upgrades/v3_7/validator.yml,0,0,0,0,1,0,1
2019-03-09 02:13:10.605751, /home/brokenquark/repo-ansi/openshift@openshift-tools/openshift/installer/vendored/openshift-ansible-3.7.42-1/playbooks/common/openshift-cluster/upgrades/v3_7/master_config_upgrade.yml,4,0,0,0,0,0,4
2019-03-09 02:13:16.888604, /home/brokenquark/repo-ansi/openshift@openshift-tools/openshift/installer/vendored/openshift-ansible-3.11.28-1/playbooks/common/openshift-cluster/upgrades/pre/verify_cluster.yml,1,0,0,0,0,0,1
2019-03-09 02:13:17.031086, /home/brokenquark/repo-ansi/openshift@openshift-tools/openshift/installer/vendored/openshift-ansible-3.11.28-1/playbooks/aws/openshift-cluster/install.yml,1,0,0,0,0,0,1
2019-03-09 02:13:17.068801, /home/brokenquark/repo-ansi/openshift@openshift-tools/openshift/installer/vendored/openshift-ansible-3.11.28-1/playbooks/azure/openshift-cluster/build_base_image.yml,1,0,0,0,0,0,1
2019-03-09 02:13:17.090235, /home/brokenquark/repo-ansi/openshift@openshift-tools/openshift/installer/vendored/openshift-ansible-3.11.28-1/playbooks/azure/openshift-cluster/build_node_image.yml,2,0,0,0,0,0,2
2019-03-09 02:13:17.106621, /home/brokenquark/repo-ansi/openshift@openshift-tools/openshift/installer/vendored/openshift-ansible-3.11.28-1/playbooks/azure/openshift-cluster/launch.yml,21,0,2,0,0,0,23
2019-03-09 02:13:17.114078, /home/brokenquark/repo-ansi/openshift@openshift-tools/openshift/installer/vendored/openshift-ansible-3.11.28-1/playbooks/azure/openshift-cluster/group_vars/all/yum_repos.yml,19,0,1,0,0,1,21
2019-03-09 02:13:17.118898, /home/brokenquark/repo-ansi/openshift@openshift-tools/openshift/installer/vendored/openshift-ansible-3.11.28-1/playbooks/azure/openshift-cluster/tasks/provision_instance.yml,1,0,0,0,0,0,1
2019-03-09 02:13:17.198174, /home/brokenquark/repo-ansi/openshift@openshift-tools/openshift/installer/vendored/openshift-ansible-3.11.28-1/playbooks/openshift-master/private/redeploy-openshift-ca.yml,9,0,0,0,0,0,9
2019-03-09 02:13:17.208483, /home/brokenquark/repo-ansi/openshift@openshift-tools/openshift/installer/vendored/openshift-ansible-3.11.28-1/playbooks/openshift-master/private/certificates-backup.yml,0,0,0,0,0,1,1
2019-03-09 02:13:17.250493, /home/brokenquark/repo-ansi/openshift@openshift-tools/openshift/installer/vendored/openshift-ansible-3.11.28-1/playbooks/openshift-master/private/revert-client-ca.yml,1,0,0,0,0,0,1
2019-03-09 02:13:17.279580, /home/brokenquark/repo-ansi/openshift@openshift-tools/openshift/installer/vendored/openshift-ansible-3.11.28-1/playbooks/openshift-master/private/upgrade.yml,0,0,0,0,1,1,2
2019-03-09 02:13:17.290558, /home/brokenquark/repo-ansi/openshift@openshift-tools/openshift/installer/vendored/openshift-ansible-3.11.28-1/playbooks/openshift-master/private/validate_restart.yml,0,0,0,0,0,1,1
2019-03-09 02:13:17.294175, /home/brokenquark/repo-ansi/openshift@openshift-tools/openshift/installer/vendored/openshift-ansible-3.11.28-1/playbooks/openshift-master/private/tasks/restart_hosts.yml,0,0,0,0,1,0,1
2019-03-09 02:13:17.478421, /home/brokenquark/repo-ansi/openshift@openshift-tools/openshift/installer/vendored/openshift-ansible-3.11.28-1/playbooks/gcp/openshift-cluster/build_base_image.yml,2,0,0,0,0,1,3
2019-03-09 02:13:17.579009, /home/brokenquark/repo-ansi/openshift@openshift-tools/openshift/installer/vendored/openshift-ansible-3.11.28-1/playbooks/byo/calico/legacy_upgrade.yml,4,0,0,0,0,1,5
2019-03-09 02:13:17.689204, /home/brokenquark/repo-ansi/openshift@openshift-tools/openshift/installer/vendored/openshift-ansible-3.11.28-1/playbooks/init/version.yml,0,0,0,0,2,0,2
2019-03-09 02:13:17.730667, /home/brokenquark/repo-ansi/openshift@openshift-tools/openshift/installer/vendored/openshift-ansible-3.11.28-1/playbooks/init/basic_facts.yml,0,0,0,0,0,1,1
2019-03-09 02:13:17.811405, /home/brokenquark/repo-ansi/openshift@openshift-tools/openshift/installer/vendored/openshift-ansible-3.11.28-1/playbooks/openshift-hosted/private/create_persistent_volumes.yml,1,0,0,0,0,0,1
2019-03-09 02:13:17.829218, /home/brokenquark/repo-ansi/openshift@openshift-tools/openshift/installer/vendored/openshift-ansible-3.11.28-1/playbooks/openshift-hosted/private/redeploy-router-certificates.yml,1,0,0,0,0,0,1
2019-03-09 02:13:17.841094, /home/brokenquark/repo-ansi/openshift@openshift-tools/openshift/installer/vendored/openshift-ansible-3.11.28-1/playbooks/openshift-hosted/private/redeploy-registry-certificates.yml,3,0,0,0,0,0,3
2019-03-09 02:13:25.315305, /home/brokenquark/repo-ansi/openshift@openshift-tools/openshift/installer/vendored/openshift-ansible-3.9.40/playbooks/common/openshift-cluster/upgrades/pre/verify_cluster.yml,1,0,0,0,0,0,1
2019-03-09 02:13:25.336140, /home/brokenquark/repo-ansi/openshift@openshift-tools/openshift/installer/vendored/openshift-ansible-3.9.40/playbooks/common/openshift-cluster/upgrades/v3_6/validator.yml,0,0,0,0,1,0,1
2019-03-09 02:13:25.372789, /home/brokenquark/repo-ansi/openshift@openshift-tools/openshift/installer/vendored/openshift-ansible-3.9.40/playbooks/common/openshift-cluster/upgrades/v3_9/upgrade_control_plane.yml,0,0,0,0,1,0,1
2019-03-09 02:13:25.379990, /home/brokenquark/repo-ansi/openshift@openshift-tools/openshift/installer/vendored/openshift-ansible-3.9.40/playbooks/common/openshift-cluster/upgrades/v3_7/validator.yml,0,0,0,0,1,0,1
2019-03-09 02:13:25.470575, /home/brokenquark/repo-ansi/openshift@openshift-tools/openshift/installer/vendored/openshift-ansible-3.9.40/playbooks/aws/openshift-cluster/install.yml,1,0,0,0,0,0,1
2019-03-09 02:13:25.491121, /home/brokenquark/repo-ansi/openshift@openshift-tools/openshift/installer/vendored/openshift-ansible-3.9.40/playbooks/azure/openshift-cluster/build_base_image.yml,1,0,0,0,0,0,1
2019-03-09 02:13:25.508579, /home/brokenquark/repo-ansi/openshift@openshift-tools/openshift/installer/vendored/openshift-ansible-3.9.40/playbooks/azure/openshift-cluster/build_node_image.yml,1,0,0,0,0,0,1
2019-03-09 02:13:25.525319, /home/brokenquark/repo-ansi/openshift@openshift-tools/openshift/installer/vendored/openshift-ansible-3.9.40/playbooks/azure/openshift-cluster/launch.yml,21,0,2,0,0,0,23
2019-03-09 02:13:25.534018, /home/brokenquark/repo-ansi/openshift@openshift-tools/openshift/installer/vendored/openshift-ansible-3.9.40/playbooks/azure/openshift-cluster/group_vars/all/yum_repos.yml,22,0,1,0,0,0,23
2019-03-09 02:13:25.538704, /home/brokenquark/repo-ansi/openshift@openshift-tools/openshift/installer/vendored/openshift-ansible-3.9.40/playbooks/azure/openshift-cluster/tasks/provision_instance.yml,1,0,0,0,0,0,1
2019-03-09 02:13:25.613443, /home/brokenquark/repo-ansi/openshift@openshift-tools/openshift/installer/vendored/openshift-ansible-3.9.40/playbooks/openshift-master/private/redeploy-openshift-ca.yml,9,0,0,0,0,0,9
2019-03-09 02:13:25.661549, /home/brokenquark/repo-ansi/openshift@openshift-tools/openshift/installer/vendored/openshift-ansible-3.9.40/playbooks/openshift-master/private/scaleup.yml,1,0,0,0,0,0,1
2019-03-09 02:13:25.681278, /home/brokenquark/repo-ansi/openshift@openshift-tools/openshift/installer/vendored/openshift-ansible-3.9.40/playbooks/openshift-master/private/revert-client-ca.yml,1,0,0,0,0,0,1
2019-03-09 02:13:25.729293, /home/brokenquark/repo-ansi/openshift@openshift-tools/openshift/installer/vendored/openshift-ansible-3.9.40/playbooks/openshift-master/private/upgrade.yml,0,0,0,0,1,0,1
2019-03-09 02:13:25.761844, /home/brokenquark/repo-ansi/openshift@openshift-tools/openshift/installer/vendored/openshift-ansible-3.9.40/playbooks/openshift-master/private/tasks/wire_aggregator.yml,12,0,0,0,1,0,13
2019-03-09 02:13:25.764742, /home/brokenquark/repo-ansi/openshift@openshift-tools/openshift/installer/vendored/openshift-ansible-3.9.40/playbooks/openshift-master/private/tasks/restart_hosts.yml,0,0,0,0,1,0,1
2019-03-09 02:13:25.908137, /home/brokenquark/repo-ansi/openshift@openshift-tools/openshift/installer/vendored/openshift-ansible-3.9.40/playbooks/gcp/openshift-cluster/build_base_image.yml,2,0,0,0,0,1,3
2019-03-09 02:13:25.991630, /home/brokenquark/repo-ansi/openshift@openshift-tools/openshift/installer/vendored/openshift-ansible-3.9.40/playbooks/byo/calico/legacy_upgrade.yml,4,0,0,0,0,0,4
2019-03-09 02:13:26.093581, /home/brokenquark/repo-ansi/openshift@openshift-tools/openshift/installer/vendored/openshift-ansible-3.9.40/playbooks/init/version.yml,0,0,0,0,2,0,2
2019-03-09 02:13:26.235428, /home/brokenquark/repo-ansi/openshift@openshift-tools/openshift/installer/vendored/openshift-ansible-3.9.40/playbooks/openshift-hosted/private/redeploy-router-certificates.yml,1,0,0,0,0,0,1
2019-03-09 02:13:26.247186, /home/brokenquark/repo-ansi/openshift@openshift-tools/openshift/installer/vendored/openshift-ansible-3.9.40/playbooks/openshift-hosted/private/redeploy-registry-certificates.yml,3,0,0,0,0,0,3
2019-03-09 02:13:33.826358, /home/brokenquark/repo-ansi/openshift@openshift-tools/openshift/installer/vendored/openshift-ansible-3.4.40/playbooks/common/openshift-master/scaleup.yml,1,0,0,0,0,0,1
2019-03-09 02:13:33.885371, /home/brokenquark/repo-ansi/openshift@openshift-tools/openshift/installer/vendored/openshift-ansible-3.4.40/playbooks/common/openshift-cluster/initialize_openshift_version.yml,0,0,0,0,2,0,2
2019-03-09 02:13:33.963456, /home/brokenquark/repo-ansi/openshift@openshift-tools/openshift/installer/vendored/openshift-ansible-3.4.40/playbooks/common/openshift-cluster/enable_dnsmasq.yml,2,0,0,0,0,0,2
2019-03-09 02:13:33.988921, /home/brokenquark/repo-ansi/openshift@openshift-tools/openshift/installer/vendored/openshift-ansible-3.4.40/playbooks/common/openshift-cluster/upgrades/containerized_node_upgrade.yml,0,0,0,0,1,0,1
2019-03-09 02:13:34.022496, /home/brokenquark/repo-ansi/openshift@openshift-tools/openshift/installer/vendored/openshift-ansible-3.4.40/playbooks/common/openshift-cluster/upgrades/upgrade_control_plane.yml,0,0,0,0,1,0,1
2019-03-09 02:13:34.105171, /home/brokenquark/repo-ansi/openshift@openshift-tools/openshift/installer/vendored/openshift-ansible-3.4.40/playbooks/common/openshift-cluster/upgrades/v3_4/master_config_upgrade.yml,3,0,0,0,0,0,3
2019-03-09 02:13:34.146078, /home/brokenquark/repo-ansi/openshift@openshift-tools/openshift/installer/vendored/openshift-ansible-3.4.40/playbooks/common/openshift-cluster/upgrades/v3_3/node_config_upgrade.yml,4,0,0,0,0,0,4
2019-03-09 02:13:34.153920, /home/brokenquark/repo-ansi/openshift@openshift-tools/openshift/installer/vendored/openshift-ansible-3.4.40/playbooks/common/openshift-cluster/upgrades/v3_3/master_config_upgrade.yml,13,0,0,0,0,0,13
2019-03-09 02:13:35.674292, /home/brokenquark/repo-ansi/openshift@openshift-tools/openshift/installer/vendored/openshift-ansible-3.5.91/playbooks/common/openshift-master/scaleup.yml,1,0,0,0,0,0,1
2019-03-09 02:13:35.680533, /home/brokenquark/repo-ansi/openshift@openshift-tools/openshift/installer/vendored/openshift-ansible-3.5.91/playbooks/common/openshift-master/restart_hosts.yml,0,0,0,0,2,0,2
2019-03-09 02:13:35.740499, /home/brokenquark/repo-ansi/openshift@openshift-tools/openshift/installer/vendored/openshift-ansible-3.5.91/playbooks/common/openshift-cluster/initialize_openshift_version.yml,0,0,0,0,2,0,2
2019-03-09 02:13:35.797717, /home/brokenquark/repo-ansi/openshift@openshift-tools/openshift/installer/vendored/openshift-ansible-3.5.91/playbooks/common/openshift-cluster/enable_dnsmasq.yml,2,0,0,0,0,0,2
2019-03-09 02:13:35.830894, /home/brokenquark/repo-ansi/openshift@openshift-tools/openshift/installer/vendored/openshift-ansible-3.5.91/playbooks/common/openshift-cluster/redeploy-certificates/registry.yml,3,0,0,0,0,0,3
2019-03-09 02:13:35.884700, /home/brokenquark/repo-ansi/openshift@openshift-tools/openshift/installer/vendored/openshift-ansible-3.5.91/playbooks/common/openshift-cluster/redeploy-certificates/openshift-ca.yml,9,0,0,0,0,0,9
2019-03-09 02:13:35.910196, /home/brokenquark/repo-ansi/openshift@openshift-tools/openshift/installer/vendored/openshift-ansible-3.5.91/playbooks/common/openshift-cluster/redeploy-certificates/router.yml,1,0,0,0,0,0,1
2019-03-09 02:13:35.929305, /home/brokenquark/repo-ansi/openshift@openshift-tools/openshift/installer/vendored/openshift-ansible-3.5.91/playbooks/common/openshift-cluster/upgrades/rpm_upgrade.yml,0,0,0,0,1,0,1
2019-03-09 02:13:35.930863, /home/brokenquark/repo-ansi/openshift@openshift-tools/openshift/installer/vendored/openshift-ansible-3.5.91/playbooks/common/openshift-cluster/upgrades/containerized_node_upgrade.yml,0,0,0,0,1,0,1
2019-03-09 02:13:35.974696, /home/brokenquark/repo-ansi/openshift@openshift-tools/openshift/installer/vendored/openshift-ansible-3.5.91/playbooks/common/openshift-cluster/upgrades/upgrade_control_plane.yml,0,0,0,0,1,0,1
2019-03-09 02:13:36.057337, /home/brokenquark/repo-ansi/openshift@openshift-tools/openshift/installer/vendored/openshift-ansible-3.5.91/playbooks/common/openshift-cluster/upgrades/v3_4/master_config_upgrade.yml,3,0,0,0,0,0,3
2019-03-09 02:13:36.094809, /home/brokenquark/repo-ansi/openshift@openshift-tools/openshift/installer/vendored/openshift-ansible-3.5.91/playbooks/common/openshift-cluster/upgrades/v3_5/validator.yml,0,0,0,0,4,0,4
2019-03-09 02:13:36.176040, /home/brokenquark/repo-ansi/openshift@openshift-tools/openshift/installer/vendored/openshift-ansible-3.5.91/playbooks/common/openshift-cluster/upgrades/v3_3/node_config_upgrade.yml,4,0,0,0,0,0,4
2019-03-09 02:13:36.183935, /home/brokenquark/repo-ansi/openshift@openshift-tools/openshift/installer/vendored/openshift-ansible-3.5.91/playbooks/common/openshift-cluster/upgrades/v3_3/master_config_upgrade.yml,13,0,0,0,0,0,13
2019-03-09 02:13:39.819986, /home/brokenquark/repo-ansi/openstack@bifrost/playbooks/roles/bifrost-prep-for-install/defaults/main.yml,1,0,0,0,0,0,1
2019-03-09 02:13:39.834668, /home/brokenquark/repo-ansi/openstack@bifrost/playbooks/roles/bifrost-ironic-install/defaults/required_defaults_Debian_family.yml,1,0,0,0,0,0,1
2019-03-09 02:13:39.838692, /home/brokenquark/repo-ansi/openstack@bifrost/playbooks/roles/bifrost-ironic-install/defaults/required_defaults_Fedora_25.yml,1,0,0,0,0,0,1
2019-03-09 02:13:39.843416, /home/brokenquark/repo-ansi/openstack@bifrost/playbooks/roles/bifrost-ironic-install/defaults/required_defaults_RedHat_family.yml,1,0,0,0,0,0,1
2019-03-09 02:13:39.847360, /home/brokenquark/repo-ansi/openstack@bifrost/playbooks/roles/bifrost-ironic-install/defaults/required_defaults_Fedora_26.yml,1,0,0,0,0,0,1
2019-03-09 02:13:39.850790, /home/brokenquark/repo-ansi/openstack@bifrost/playbooks/roles/bifrost-ironic-install/defaults/required_defaults_Debian_jessie.yml,1,0,0,0,0,0,1
2019-03-09 02:13:39.882754, /home/brokenquark/repo-ansi/openstack@bifrost/playbooks/roles/bifrost-ironic-install/defaults/main.yml,12,1,0,0,3,0,16
2019-03-09 02:13:39.886868, /home/brokenquark/repo-ansi/openstack@bifrost/playbooks/roles/bifrost-ironic-install/defaults/required_defaults_Fedora_27.yml,1,0,0,0,0,0,1
2019-03-09 02:13:39.895296, /home/brokenquark/repo-ansi/openstack@bifrost/playbooks/roles/bifrost-ironic-install/defaults/required_defaults_Suse_family.yml,1,0,0,0,0,0,1
2019-03-09 02:13:39.899829, /home/brokenquark/repo-ansi/openstack@bifrost/playbooks/roles/bifrost-ironic-install/defaults/required_defaults_openSUSE_Leap_15.0.yml,1,0,0,0,0,0,1
2019-03-09 02:13:39.906353, /home/brokenquark/repo-ansi/openstack@bifrost/playbooks/roles/bifrost-ironic-install/tasks/ironic_config.yml,1,0,0,0,0,0,1
2019-03-09 02:13:39.924960, /home/brokenquark/repo-ansi/openstack@bifrost/playbooks/roles/bifrost-ironic-install/tasks/inspector_bootstrap.yml,2,0,0,0,0,0,2
2019-03-09 02:13:39.955043, /home/brokenquark/repo-ansi/openstack@bifrost/playbooks/roles/bifrost-ironic-install/tasks/keystone_setup.yml,20,0,0,0,0,0,20
2019-03-09 02:13:39.991527, /home/brokenquark/repo-ansi/openstack@bifrost/playbooks/roles/bifrost-ironic-install/tasks/create_tftpboot.yml,1,0,0,0,0,0,1
2019-03-09 02:13:40.015973, /home/brokenquark/repo-ansi/openstack@bifrost/playbooks/roles/bifrost-ironic-install/tasks/keystone_setup_inspector.yml,12,0,0,0,0,0,12
2019-03-09 02:13:40.092229, /home/brokenquark/repo-ansi/openstack@bifrost/playbooks/roles/bifrost-ironic-install/tasks/bootstrap.yml,12,0,0,0,0,0,12
2019-03-09 02:13:40.123262, /home/brokenquark/repo-ansi/openstack@bifrost/playbooks/roles/bifrost-deploy-nodes-dynamic/tasks/main.yml,2,0,0,0,0,0,2
2019-03-09 02:13:40.137576, /home/brokenquark/repo-ansi/openstack@bifrost/playbooks/roles/bifrost-keystone-install/defaults/required_defaults_Debian_family.yml,1,0,0,0,0,0,1
2019-03-09 02:13:40.140572, /home/brokenquark/repo-ansi/openstack@bifrost/playbooks/roles/bifrost-keystone-install/defaults/required_defaults_RedHat_family.yml,1,0,0,0,0,0,1
2019-03-09 02:13:40.142453, /home/brokenquark/repo-ansi/openstack@bifrost/playbooks/roles/bifrost-keystone-install/defaults/required_defaults_Debian_jessie.yml,1,0,0,0,0,0,1
2019-03-09 02:13:40.149718, /home/brokenquark/repo-ansi/openstack@bifrost/playbooks/roles/bifrost-keystone-install/defaults/main.yml,7,1,0,0,0,0,8
2019-03-09 02:13:40.174786, /home/brokenquark/repo-ansi/openstack@bifrost/playbooks/roles/bifrost-keystone-install/tasks/install.yml,0,0,0,0,1,0,1
2019-03-09 02:13:40.211514, /home/brokenquark/repo-ansi/openstack@bifrost/playbooks/roles/bifrost-keystone-install/tasks/bootstrap.yml,9,0,0,0,1,0,10
2019-03-09 02:13:40.259725, /home/brokenquark/repo-ansi/openstack@bifrost/playbooks/roles/bifrost-openstack-ci-prep/defaults/main.yml,1,0,0,0,0,0,1
2019-03-09 02:13:40.263620, /home/brokenquark/repo-ansi/openstack@bifrost/playbooks/roles/bifrost-openstack-ci-prep/tasks/main.yml,2,0,0,0,0,0,2
2019-03-09 02:13:40.312432, /home/brokenquark/repo-ansi/openstack@bifrost/playbooks/roles/ironic-inspect-node/tasks/main.yml,2,0,0,0,1,0,3
2019-03-09 02:13:40.354849, /home/brokenquark/repo-ansi/openstack@bifrost/playbooks/roles/bifrost-create-vm-nodes/tasks/prepare_libvirt.yml,0,0,0,0,1,0,1
2019-03-09 02:13:40.372030, /home/brokenquark/repo-ansi/openstack@bifrost/playbooks/roles/bifrost-create-vm-nodes/tasks/create_vm.yml,2,0,0,0,0,0,2
2019-03-09 02:13:40.384732, /home/brokenquark/repo-ansi/openstack@bifrost/playbooks/roles/bifrost-create-vm-nodes/tasks/main.yml,0,0,0,0,2,0,2
2019-03-09 02:13:40.390516, /home/brokenquark/repo-ansi/openstack@bifrost/playbooks/roles/bifrost-configdrives-dynamic/defaults/main.yml,1,0,0,0,0,0,1
2019-03-09 02:13:40.770454, /home/brokenquark/repo-ansi/openstack@networking-ovn/migration/tripleo_environment/playbooks/roles/resources/validate/defaults/main.yml,1,0,0,0,0,0,1
2019-03-09 02:13:40.776365, /home/brokenquark/repo-ansi/openstack@networking-ovn/migration/tripleo_environment/playbooks/roles/backup/tasks/main.yml,0,0,0,0,1,0,1
2019-03-09 02:13:40.796709, /home/brokenquark/repo-ansi/openstack@networking-ovn/playbooks/legacy/tempest-post-common.yml,0,0,0,0,1,0,1
2019-03-09 02:13:41.959395, /home/brokenquark/repo-ansi/openstack@openstack-ansible/playbooks/etcd-install.yml,1,0,0,0,0,0,1
2019-03-09 02:13:41.967720, /home/brokenquark/repo-ansi/openstack@openstack-ansible/playbooks/os-trove-install.yml,1,0,0,0,0,0,1
2019-03-09 02:13:41.972286, /home/brokenquark/repo-ansi/openstack@openstack-ansible/playbooks/os-tacker-install.yml,1,0,0,0,0,0,1
2019-03-09 02:13:41.977376, /home/brokenquark/repo-ansi/openstack@openstack-ansible/playbooks/memcached-install.yml,1,0,0,0,0,0,1
2019-03-09 02:13:41.996799, /home/brokenquark/repo-ansi/openstack@openstack-ansible/playbooks/ceph-rgw-install.yml,1,0,0,0,0,0,1
2019-03-09 02:13:42.009686, /home/brokenquark/repo-ansi/openstack@openstack-ansible/playbooks/ceph-rgw-keystone-setup.yml,1,0,0,0,0,0,1
2019-03-09 02:13:42.016007, /home/brokenquark/repo-ansi/openstack@openstack-ansible/playbooks/openstack-hosts-setup.yml,2,0,0,0,0,0,2
2019-03-09 02:13:42.093190, /home/brokenquark/repo-ansi/openstack@openstack-ansible/playbooks/os-gnocchi-install.yml,1,0,0,0,0,0,1
2019-03-09 02:13:42.102208, /home/brokenquark/repo-ansi/openstack@openstack-ansible/playbooks/rabbitmq-install.yml,4,0,0,0,0,0,4
2019-03-09 02:13:42.118462, /home/brokenquark/repo-ansi/openstack@openstack-ansible/playbooks/os-keystone-install.yml,2,0,0,0,0,0,2
2019-03-09 02:13:42.133677, /home/brokenquark/repo-ansi/openstack@openstack-ansible/playbooks/os-glance-install.yml,2,0,0,0,0,0,2
2019-03-09 02:13:42.159542, /home/brokenquark/repo-ansi/openstack@openstack-ansible/playbooks/healthcheck-infrastructure.yml,4,0,0,0,0,0,4
2019-03-09 02:13:42.164370, /home/brokenquark/repo-ansi/openstack@openstack-ansible/playbooks/os-barbican-install.yml,1,0,0,0,0,0,1
2019-03-09 02:13:42.183506, /home/brokenquark/repo-ansi/openstack@openstack-ansible/playbooks/os-nova-install.yml,4,0,0,0,0,0,4
2019-03-09 02:13:42.186218, /home/brokenquark/repo-ansi/openstack@openstack-ansible/playbooks/os-swift-sync.yml,1,0,0,0,0,0,1
2019-03-09 02:13:42.191357, /home/brokenquark/repo-ansi/openstack@openstack-ansible/playbooks/containers-nspawn-host.yml,1,0,0,0,0,0,1
2019-03-09 02:13:42.200107, /home/brokenquark/repo-ansi/openstack@openstack-ansible/playbooks/os-octavia-install.yml,1,0,0,0,0,0,1
2019-03-09 02:13:42.206869, /home/brokenquark/repo-ansi/openstack@openstack-ansible/playbooks/unbound-install.yml,2,0,0,0,0,0,2
2019-03-09 02:13:42.217605, /home/brokenquark/repo-ansi/openstack@openstack-ansible/playbooks/os-congress-install.yml,1,0,0,0,0,0,1
2019-03-09 02:13:42.226214, /home/brokenquark/repo-ansi/openstack@openstack-ansible/playbooks/os-designate-install.yml,1,0,0,0,0,0,1
2019-03-09 02:13:42.243169, /home/brokenquark/repo-ansi/openstack@openstack-ansible/playbooks/infra-journal-remote.yml,7,0,0,0,0,0,7
2019-03-09 02:13:42.247390, /home/brokenquark/repo-ansi/openstack@openstack-ansible/playbooks/os-tempest-install.yml,1,0,0,0,0,0,1
2019-03-09 02:13:42.255341, /home/brokenquark/repo-ansi/openstack@openstack-ansible/playbooks/os-swift-install.yml,2,0,0,0,0,0,2
2019-03-09 02:13:42.266342, /home/brokenquark/repo-ansi/openstack@openstack-ansible/playbooks/repo-build.yml,1,0,0,0,0,0,1
2019-03-09 02:13:42.276443, /home/brokenquark/repo-ansi/openstack@openstack-ansible/playbooks/os-horizon-install.yml,1,0,0,0,0,0,1
2019-03-09 02:13:42.281168, /home/brokenquark/repo-ansi/openstack@openstack-ansible/playbooks/os-ceilometer-install.yml,1,0,0,0,0,0,1
2019-03-09 02:13:42.286823, /home/brokenquark/repo-ansi/openstack@openstack-ansible/playbooks/os-blazar-install.yml,1,0,0,0,0,0,1
2019-03-09 02:13:42.301702, /home/brokenquark/repo-ansi/openstack@openstack-ansible/playbooks/containers-nspawn-create.yml,3,0,0,0,0,0,3
2019-03-09 02:13:42.309794, /home/brokenquark/repo-ansi/openstack@openstack-ansible/playbooks/galera-install.yml,2,0,0,0,0,0,2
2019-03-09 02:13:42.318105, /home/brokenquark/repo-ansi/openstack@openstack-ansible/playbooks/containers-lxc-create.yml,3,0,0,0,0,0,3
2019-03-09 02:13:42.320932, /home/brokenquark/repo-ansi/openstack@openstack-ansible/playbooks/os-rally-install.yml,1,0,0,0,0,0,1
2019-03-09 02:13:42.323339, /home/brokenquark/repo-ansi/openstack@openstack-ansible/playbooks/security-hardening.yml,1,0,0,0,0,0,1
2019-03-09 02:13:42.342191, /home/brokenquark/repo-ansi/openstack@openstack-ansible/playbooks/ceph-install.yml,3,0,0,0,0,0,3
2019-03-09 02:13:42.362216, /home/brokenquark/repo-ansi/openstack@openstack-ansible/playbooks/os-cinder-install.yml,4,0,0,0,0,0,4
2019-03-09 02:13:42.375831, /home/brokenquark/repo-ansi/openstack@openstack-ansible/playbooks/utility-install.yml,3,0,0,0,0,0,3
2019-03-09 02:13:42.383996, /home/brokenquark/repo-ansi/openstack@openstack-ansible/playbooks/containers-lxc-host.yml,1,0,0,0,0,0,1
2019-03-09 02:13:42.388788, /home/brokenquark/repo-ansi/openstack@openstack-ansible/playbooks/rsyslog-install.yml,1,0,0,0,0,0,1
2019-03-09 02:13:42.393391, /home/brokenquark/repo-ansi/openstack@openstack-ansible/playbooks/os-magnum-install.yml,1,0,0,0,0,0,1
2019-03-09 02:13:42.405686, /home/brokenquark/repo-ansi/openstack@openstack-ansible/playbooks/containers-nspawn-destroy.yml,2,0,0,0,0,0,2
2019-03-09 02:13:42.415263, /home/brokenquark/repo-ansi/openstack@openstack-ansible/playbooks/os-heat-install.yml,1,0,0,0,0,0,1
2019-03-09 02:13:42.425642, /home/brokenquark/repo-ansi/openstack@openstack-ansible/playbooks/lxc-containers-destroy.yml,2,0,0,0,0,0,2
2019-03-09 02:13:42.430374, /home/brokenquark/repo-ansi/openstack@openstack-ansible/playbooks/os-aodh-install.yml,1,0,0,0,0,0,1
2019-03-09 02:13:42.438462, /home/brokenquark/repo-ansi/openstack@openstack-ansible/playbooks/haproxy-install.yml,1,0,0,0,0,0,1
2019-03-09 02:13:42.446745, /home/brokenquark/repo-ansi/openstack@openstack-ansible/playbooks/lxc-containers-create.yml,3,0,0,0,0,0,3
2019-03-09 02:13:42.457826, /home/brokenquark/repo-ansi/openstack@openstack-ansible/playbooks/containers-lxc-destroy.yml,2,0,0,0,0,0,2
2019-03-09 02:13:42.462465, /home/brokenquark/repo-ansi/openstack@openstack-ansible/playbooks/os-ironic-install.yml,1,0,0,0,0,0,1
2019-03-09 02:13:42.469917, /home/brokenquark/repo-ansi/openstack@openstack-ansible/playbooks/lxc-hosts-setup.yml,1,0,0,0,0,0,1
2019-03-09 02:13:42.478403, /home/brokenquark/repo-ansi/openstack@openstack-ansible/playbooks/repo-server.yml,1,0,0,0,0,0,1
2019-03-09 02:13:42.483173, /home/brokenquark/repo-ansi/openstack@openstack-ansible/playbooks/os-sahara-install.yml,1,0,0,0,0,0,1
2019-03-09 02:13:42.497661, /home/brokenquark/repo-ansi/openstack@openstack-ansible/playbooks/common-playbooks/neutron.yml,1,0,0,0,0,0,1
2019-03-09 02:13:42.519949, /home/brokenquark/repo-ansi/openstack@openstack-ansible/playbooks/common-playbooks/nova.yml,1,0,0,0,0,0,1
2019-03-09 02:13:42.532611, /home/brokenquark/repo-ansi/openstack@openstack-ansible/playbooks/common-playbooks/cinder.yml,1,0,0,0,0,0,1
2019-03-09 02:13:42.541650, /home/brokenquark/repo-ansi/openstack@openstack-ansible/playbooks/common-playbooks/glance.yml,1,0,0,0,0,0,1
2019-03-09 02:13:42.560552, /home/brokenquark/repo-ansi/openstack@openstack-ansible/playbooks/defaults/healthchecks-vars.yml,2,0,2,3,0,0,7
2019-03-09 02:13:42.626117, /home/brokenquark/repo-ansi/openstack@openstack-ansible/playbooks/common-tasks/ceph-server.yml,0,0,1,0,1,0,2
2019-03-09 02:13:42.645927, /home/brokenquark/repo-ansi/openstack@openstack-ansible/playbooks/common-tasks/os-lxc-container-setup.yml,0,0,0,0,4,0,4
2019-03-09 02:13:42.650618, /home/brokenquark/repo-ansi/openstack@openstack-ansible/playbooks/common-tasks/unbound-clients.yml,0,0,0,0,1,0,1
2019-03-09 02:13:42.658646, /home/brokenquark/repo-ansi/openstack@openstack-ansible/playbooks/common-tasks/restart-service.yml,0,0,0,0,1,0,1
2019-03-09 02:13:42.681948, /home/brokenquark/repo-ansi/openstack@openstack-ansible/playbooks/roles/system_crontab_coordination/tasks/main.yml,1,0,0,0,0,0,1
2019-03-09 02:13:42.743822, /home/brokenquark/repo-ansi/openstack@openstack-ansible/zuul.d/playbooks/post.yml,2,0,0,0,0,1,3
2019-03-09 02:13:42.745850, /home/brokenquark/repo-ansi/openstack@openstack-ansible/zuul.d/playbooks/run.yml,1,0,0,0,0,0,1
2019-03-09 02:13:46.965334, /home/brokenquark/repo-ansi/openstack@tripleo-common/playbooks/octavia-files.yaml,1,0,0,0,0,0,1
2019-03-09 02:13:46.973778, /home/brokenquark/repo-ansi/openstack@tripleo-common/playbooks/rotate-keys.yaml,1,0,0,0,0,0,1
2019-03-09 02:13:46.994108, /home/brokenquark/repo-ansi/openstack@tripleo-common/playbooks/roles/common/defaults/main.yml,1,0,0,0,0,0,1
2019-03-09 02:13:47.013058, /home/brokenquark/repo-ansi/openstack@tripleo-common/playbooks/roles/octavia-controller-config/tasks/octavia.yml,3,0,0,0,0,0,3
2019-03-09 02:13:47.016030, /home/brokenquark/repo-ansi/openstack@tripleo-common/playbooks/roles/octavia-controller-config/tasks/netinterface.yml,3,0,0,0,0,0,3
2019-03-09 02:13:47.023984, /home/brokenquark/repo-ansi/openstack@tripleo-common/playbooks/roles/octavia-controller-post-config/tasks/main.yml,3,0,0,0,0,0,3
2019-03-09 02:13:47.064117, /home/brokenquark/repo-ansi/openstack@tripleo-common/playbooks/roles/octavia-undercloud/tasks/main.yml,1,0,0,0,0,0,1
2019-03-09 02:13:50.252563, /home/brokenquark/repo-ansi/os-cloud@os-ansible-deployment/playbooks/etcd-install.yml,1,0,0,0,0,0,1
2019-03-09 02:13:50.264994, /home/brokenquark/repo-ansi/os-cloud@os-ansible-deployment/playbooks/os-trove-install.yml,1,0,0,0,0,0,1
2019-03-09 02:13:50.270067, /home/brokenquark/repo-ansi/os-cloud@os-ansible-deployment/playbooks/memcached-install.yml,1,0,0,0,0,0,1
2019-03-09 02:13:50.275426, /home/brokenquark/repo-ansi/os-cloud@os-ansible-deployment/playbooks/openstack-hosts-setup.yml,2,0,0,0,0,0,2
2019-03-09 02:13:50.284403, /home/brokenquark/repo-ansi/os-cloud@os-ansible-deployment/playbooks/os-gnocchi-install.yml,2,0,0,0,0,0,2
2019-03-09 02:13:50.293799, /home/brokenquark/repo-ansi/os-cloud@os-ansible-deployment/playbooks/rabbitmq-install.yml,4,0,0,0,0,0,4
2019-03-09 02:13:50.309318, /home/brokenquark/repo-ansi/os-cloud@os-ansible-deployment/playbooks/os-keystone-install.yml,3,0,0,0,0,0,3
2019-03-09 02:13:50.322963, /home/brokenquark/repo-ansi/os-cloud@os-ansible-deployment/playbooks/os-glance-install.yml,2,0,0,0,0,0,2
2019-03-09 02:13:50.334605, /home/brokenquark/repo-ansi/os-cloud@os-ansible-deployment/playbooks/os-barbican-install.yml,1,0,0,0,0,0,1
2019-03-09 02:13:50.341380, /home/brokenquark/repo-ansi/os-cloud@os-ansible-deployment/playbooks/os-molteniron-install.yml,2,0,0,0,0,0,2
2019-03-09 02:13:50.369368, /home/brokenquark/repo-ansi/os-cloud@os-ansible-deployment/playbooks/os-nova-install.yml,4,0,0,0,0,0,4
2019-03-09 02:13:50.372305, /home/brokenquark/repo-ansi/os-cloud@os-ansible-deployment/playbooks/os-swift-sync.yml,1,0,0,0,0,0,1
2019-03-09 02:13:50.383456, /home/brokenquark/repo-ansi/os-cloud@os-ansible-deployment/playbooks/os-octavia-install.yml,2,0,0,0,0,0,2
2019-03-09 02:13:50.396356, /home/brokenquark/repo-ansi/os-cloud@os-ansible-deployment/playbooks/unbound-install.yml,2,0,0,0,0,0,2
2019-03-09 02:13:50.406969, /home/brokenquark/repo-ansi/os-cloud@os-ansible-deployment/playbooks/os-designate-install.yml,1,0,0,0,0,0,1
2019-03-09 02:13:50.412353, /home/brokenquark/repo-ansi/os-cloud@os-ansible-deployment/playbooks/os-tempest-install.yml,1,0,0,0,0,0,1
2019-03-09 02:13:50.423648, /home/brokenquark/repo-ansi/os-cloud@os-ansible-deployment/playbooks/os-swift-install.yml,3,0,0,0,0,0,3
2019-03-09 02:13:50.446022, /home/brokenquark/repo-ansi/os-cloud@os-ansible-deployment/playbooks/repo-build.yml,1,0,0,0,0,0,1
2019-03-09 02:13:50.462393, /home/brokenquark/repo-ansi/os-cloud@os-ansible-deployment/playbooks/os-horizon-install.yml,2,0,0,0,0,0,2
2019-03-09 02:13:50.469847, /home/brokenquark/repo-ansi/os-cloud@os-ansible-deployment/playbooks/os-ceilometer-install.yml,1,0,0,0,0,0,1
2019-03-09 02:13:50.480017, /home/brokenquark/repo-ansi/os-cloud@os-ansible-deployment/playbooks/galera-install.yml,2,0,0,0,0,0,2
2019-03-09 02:13:50.483408, /home/brokenquark/repo-ansi/os-cloud@os-ansible-deployment/playbooks/os-rally-install.yml,1,0,0,0,0,0,1
2019-03-09 02:13:50.485924, /home/brokenquark/repo-ansi/os-cloud@os-ansible-deployment/playbooks/security-hardening.yml,1,0,0,0,0,0,1
2019-03-09 02:13:50.507497, /home/brokenquark/repo-ansi/os-cloud@os-ansible-deployment/playbooks/ceph-install.yml,3,0,2,0,0,0,5
2019-03-09 02:13:50.526623, /home/brokenquark/repo-ansi/os-cloud@os-ansible-deployment/playbooks/os-cinder-install.yml,2,0,0,0,0,0,2
2019-03-09 02:13:50.542571, /home/brokenquark/repo-ansi/os-cloud@os-ansible-deployment/playbooks/utility-install.yml,3,0,0,0,0,0,3
2019-03-09 02:13:50.550793, /home/brokenquark/repo-ansi/os-cloud@os-ansible-deployment/playbooks/rsyslog-install.yml,1,0,0,0,0,0,1
2019-03-09 02:13:50.560607, /home/brokenquark/repo-ansi/os-cloud@os-ansible-deployment/playbooks/os-magnum-install.yml,1,0,0,0,0,0,1
2019-03-09 02:13:50.589329, /home/brokenquark/repo-ansi/os-cloud@os-ansible-deployment/playbooks/os-neutron-install.yml,1,0,0,0,0,0,1
2019-03-09 02:13:50.602314, /home/brokenquark/repo-ansi/os-cloud@os-ansible-deployment/playbooks/os-heat-install.yml,2,0,0,0,0,0,2
2019-03-09 02:13:50.611399, /home/brokenquark/repo-ansi/os-cloud@os-ansible-deployment/playbooks/lxc-containers-destroy.yml,1,0,0,0,0,0,1
2019-03-09 02:13:50.621689, /home/brokenquark/repo-ansi/os-cloud@os-ansible-deployment/playbooks/os-aodh-install.yml,3,0,0,0,0,0,3
2019-03-09 02:13:50.634021, /home/brokenquark/repo-ansi/os-cloud@os-ansible-deployment/playbooks/haproxy-install.yml,2,0,0,0,0,0,2
2019-03-09 02:13:50.638648, /home/brokenquark/repo-ansi/os-cloud@os-ansible-deployment/playbooks/lxc-containers-create.yml,1,0,0,0,0,0,1
2019-03-09 02:13:50.649129, /home/brokenquark/repo-ansi/os-cloud@os-ansible-deployment/playbooks/os-ironic-install.yml,2,0,0,0,0,0,2
2019-03-09 02:13:50.657817, /home/brokenquark/repo-ansi/os-cloud@os-ansible-deployment/playbooks/lxc-hosts-setup.yml,1,0,0,0,0,0,1
2019-03-09 02:13:50.668526, /home/brokenquark/repo-ansi/os-cloud@os-ansible-deployment/playbooks/repo-server.yml,1,0,0,0,0,0,1
2019-03-09 02:13:50.682278, /home/brokenquark/repo-ansi/os-cloud@os-ansible-deployment/playbooks/os-sahara-install.yml,1,0,0,0,0,0,1
2019-03-09 02:13:50.824553, /home/brokenquark/repo-ansi/os-cloud@os-ansible-deployment/playbooks/common-tasks/os-lxc-container-setup.yml,0,0,0,0,4,0,4
2019-03-09 02:13:50.842316, /home/brokenquark/repo-ansi/os-cloud@os-ansible-deployment/playbooks/roles/system_crontab_coordination/tasks/main.yml,1,0,0,0,0,0,1
2019-03-09 02:13:50.852290, /home/brokenquark/repo-ansi/os-cloud@os-ansible-deployment/playbooks/inventory/group_vars/utility_all.yml,1,0,0,0,0,0,1
2019-03-09 02:13:50.874939, /home/brokenquark/repo-ansi/os-cloud@os-ansible-deployment/playbooks/inventory/group_vars/horizon_all.yml,2,0,0,0,0,0,2
2019-03-09 02:13:50.877078, /home/brokenquark/repo-ansi/os-cloud@os-ansible-deployment/playbooks/inventory/group_vars/ironic_all.yml,1,0,0,0,0,0,1
2019-03-09 02:13:50.881577, /home/brokenquark/repo-ansi/os-cloud@os-ansible-deployment/playbooks/inventory/group_vars/barbican_all.yml,3,0,0,0,0,0,3
2019-03-09 02:13:50.887388, /home/brokenquark/repo-ansi/os-cloud@os-ansible-deployment/playbooks/inventory/group_vars/designate_all.yml,3,0,0,0,0,0,3
2019-03-09 02:13:50.899208, /home/brokenquark/repo-ansi/os-cloud@os-ansible-deployment/playbooks/inventory/group_vars/magnum_all.yml,3,0,0,0,0,0,3
2019-03-09 02:13:50.987394, /home/brokenquark/repo-ansi/os-cloud@os-ansible-deployment/playbooks/inventory/group_vars/all.yml,34,0,0,0,1,0,35
2019-03-09 02:13:50.990029, /home/brokenquark/repo-ansi/os-cloud@os-ansible-deployment/playbooks/inventory/group_vars/neutron_all.yml,1,0,0,0,0,0,1
2019-03-09 02:13:50.994646, /home/brokenquark/repo-ansi/os-cloud@os-ansible-deployment/playbooks/inventory/group_vars/neutron_agent.yml,0,0,0,0,1,0,1
2019-03-09 02:13:51.002973, /home/brokenquark/repo-ansi/os-cloud@os-ansible-deployment/playbooks/inventory/group_vars/trove_all.yml,3,0,0,0,0,0,3
2019-03-09 02:13:51.004886, /home/brokenquark/repo-ansi/os-cloud@os-ansible-deployment/playbooks/inventory/group_vars/rabbitmq_all.yml,0,0,0,0,1,0,1
2019-03-09 02:13:51.015248, /home/brokenquark/repo-ansi/os-cloud@os-ansible-deployment/playbooks/inventory/group_vars/repo_all.yml,1,0,0,0,0,0,1
2019-03-09 02:13:51.233165, /home/brokenquark/repo-ansi/os-cloud@os-ansible-deployment/scripts/upgrade-utilities/playbooks/memcached-flush.yml,1,0,0,0,0,0,1
2019-03-09 02:13:51.235916, /home/brokenquark/repo-ansi/os-cloud@os-ansible-deployment/scripts/upgrade-utilities/playbooks/ansible_fact_cleanup.yml,1,0,0,0,0,0,1
2019-03-09 02:13:51.244571, /home/brokenquark/repo-ansi/os-cloud@os-ansible-deployment/scripts/upgrade-utilities/playbooks/galera-cluster-rolling-restart.yml,1,0,0,0,0,0,1
2019-03-09 02:13:51.252091, /home/brokenquark/repo-ansi/os-cloud@os-ansible-deployment/scripts/upgrade-utilities/playbooks/user-secrets-adjustment.yml,1,0,0,0,0,0,1
2019-03-09 02:13:51.254615, /home/brokenquark/repo-ansi/os-cloud@os-ansible-deployment/scripts/upgrade-utilities/playbooks/pip-conf-removal.yml,1,0,0,0,0,0,1
2019-03-09 02:13:51.266745, /home/brokenquark/repo-ansi/os-cloud@os-ansible-deployment/scripts/upgrade-utilities/playbooks/deploy-config-changes.yml,2,0,0,0,0,0,2
2019-03-09 02:13:51.411256, /home/brokenquark/repo-ansi/ovnicraft@evex-configuration/playbooks/roles/jenkins_master/defaults/main.yml,1,0,1,0,0,0,2
2019-03-09 02:13:51.428505, /home/brokenquark/repo-ansi/ovnicraft@evex-configuration/playbooks/roles/jenkins_master/tasks/main.yml,1,0,0,0,4,0,5
2019-03-09 02:13:51.435351, /home/brokenquark/repo-ansi/ovnicraft@evex-configuration/playbooks/roles/common/defaults/main.yml,2,0,0,0,0,0,2
2019-03-09 02:13:51.445776, /home/brokenquark/repo-ansi/ovnicraft@evex-configuration/playbooks/roles/common/tasks/main.yml,0,0,0,0,1,0,1
2019-03-09 02:13:51.460349, /home/brokenquark/repo-ansi/ovnicraft@evex-configuration/playbooks/roles/xserver/defaults/main.yml,3,0,0,0,0,0,3
2019-03-09 02:13:51.495321, /home/brokenquark/repo-ansi/ovnicraft@evex-configuration/playbooks/roles/forum/defaults/main.yml,4,0,0,0,0,0,4
2019-03-09 02:13:51.550299, /home/brokenquark/repo-ansi/ovnicraft@evex-configuration/playbooks/roles/ora/defaults/main.yml,14,1,1,0,0,1,17
2019-03-09 02:13:51.595633, /home/brokenquark/repo-ansi/ovnicraft@evex-configuration/playbooks/roles/gh_mirror/defaults/main.yml,1,0,0,0,0,0,1
2019-03-09 02:13:51.619904, /home/brokenquark/repo-ansi/ovnicraft@evex-configuration/playbooks/roles/analytics/defaults/main.yml,8,0,0,0,0,0,8
2019-03-09 02:13:51.670569, /home/brokenquark/repo-ansi/ovnicraft@evex-configuration/playbooks/roles/devpi/defaults/main.yml,2,0,0,0,0,0,2
2019-03-09 02:13:51.775301, /home/brokenquark/repo-ansi/ovnicraft@evex-configuration/playbooks/roles/gluster/tasks/main.yml,0,0,0,0,1,0,1
2019-03-09 02:13:51.789850, /home/brokenquark/repo-ansi/ovnicraft@evex-configuration/playbooks/roles/certs/defaults/main.yml,9,0,0,0,0,0,9
2019-03-09 02:13:51.823217, /home/brokenquark/repo-ansi/ovnicraft@evex-configuration/playbooks/roles/demo/defaults/main.yml,4,0,0,0,0,0,4
2019-03-09 02:13:51.843592, /home/brokenquark/repo-ansi/ovnicraft@evex-configuration/playbooks/roles/oraclejdk/defaults/main.yml,0,0,1,0,0,0,1
2019-03-09 02:13:51.862984, /home/brokenquark/repo-ansi/ovnicraft@evex-configuration/playbooks/roles/splunkforwarder/defaults/main.yml,0,1,0,0,0,0,1
2019-03-09 02:13:51.880278, /home/brokenquark/repo-ansi/ovnicraft@evex-configuration/playbooks/roles/splunkforwarder/tasks/main.yml,1,0,0,0,0,0,1
2019-03-09 02:13:51.901258, /home/brokenquark/repo-ansi/ovnicraft@evex-configuration/playbooks/roles/notifier/defaults/main.yml,6,2,0,0,0,0,8
2019-03-09 02:13:51.927962, /home/brokenquark/repo-ansi/ovnicraft@evex-configuration/playbooks/roles/automated/defaults/main.yml,1,0,0,0,0,0,1
2019-03-09 02:13:51.967153, /home/brokenquark/repo-ansi/ovnicraft@evex-configuration/playbooks/roles/edx_ansible/defaults/main.yml,1,0,0,0,0,0,1
2019-03-09 02:13:51.986139, /home/brokenquark/repo-ansi/ovnicraft@evex-configuration/playbooks/roles/s3fs/defaults/main.yml,0,0,1,0,0,0,1
2019-03-09 02:13:52.000560, /home/brokenquark/repo-ansi/ovnicraft@evex-configuration/playbooks/roles/mongo/defaults/main.yml,5,0,0,0,0,0,5
2019-03-09 02:13:52.011840, /home/brokenquark/repo-ansi/ovnicraft@evex-configuration/playbooks/roles/mongo/tasks/main.yml,1,0,0,0,0,0,1
2019-03-09 02:13:52.110326, /home/brokenquark/repo-ansi/ovnicraft@evex-configuration/playbooks/roles/edxapp/defaults/main.yml,101,1,0,0,0,0,102
2019-03-09 02:13:52.154531, /home/brokenquark/repo-ansi/ovnicraft@evex-configuration/playbooks/roles/edxapp/tasks/deploy.yml,0,0,0,0,2,0,2
2019-03-09 02:13:52.216888, /home/brokenquark/repo-ansi/ovnicraft@evex-configuration/playbooks/roles/rabbitmq/defaults/main.yml,4,0,1,0,0,0,5
2019-03-09 02:13:52.231395, /home/brokenquark/repo-ansi/ovnicraft@evex-configuration/playbooks/roles/rabbitmq/tasks/main.yml,1,0,0,0,1,0,2
2019-03-09 02:13:52.245275, /home/brokenquark/repo-ansi/ovnicraft@evex-configuration/playbooks/roles/analytics-server/defaults/main.yml,8,0,0,0,0,0,8
2019-03-09 02:13:52.288286, /home/brokenquark/repo-ansi/ovnicraft@evex-configuration/playbooks/roles/supervisor/defaults/main.yml,1,0,0,0,0,0,1
2019-03-09 02:13:52.304979, /home/brokenquark/repo-ansi/ovnicraft@evex-configuration/playbooks/roles/gh_users/defaults/main.yml,0,0,0,0,1,0,1
2019-03-09 02:13:52.315462, /home/brokenquark/repo-ansi/ovnicraft@evex-configuration/playbooks/roles/browsers/defaults/main.yml,0,0,1,0,0,1,2
2019-03-09 02:13:52.341771, /home/brokenquark/repo-ansi/ovnicraft@evex-configuration/playbooks/roles/discern/defaults/main.yml,4,1,1,0,0,1,7
2019-03-09 02:13:52.382820, /home/brokenquark/repo-ansi/ovnicraft@evex-configuration/playbooks/roles/discern/tasks/main.yml,0,0,0,0,1,0,1
2019-03-09 02:13:52.449676, /home/brokenquark/repo-ansi/ovnicraft@evex-configuration/playbooks/roles/jenkins_worker/defaults/main.yml,1,0,1,0,0,1,3
2019-03-09 02:13:52.456111, /home/brokenquark/repo-ansi/ovnicraft@evex-configuration/playbooks/roles/jenkins_worker/tasks/system.yml,0,0,0,0,1,0,1
2019-03-09 02:13:52.472841, /home/brokenquark/repo-ansi/ovnicraft@evex-configuration/playbooks/roles/datadog/defaults/main.yml,2,0,1,0,0,0,3
2019-03-09 02:13:52.499670, /home/brokenquark/repo-ansi/ovnicraft@evex-configuration/playbooks/roles/xqueue/defaults/main.yml,12,1,0,0,0,0,13
2019-03-09 02:13:52.533301, /home/brokenquark/repo-ansi/ovnicraft@evex-configuration/playbooks/roles/nginx/defaults/main.yml,1,2,0,0,0,0,3
2019-03-09 02:13:52.552482, /home/brokenquark/repo-ansi/ovnicraft@evex-configuration/playbooks/roles/shibboleth/defaults/main.yml,3,0,1,0,0,0,4
2019-03-09 02:13:52.616753, /home/brokenquark/repo-ansi/ovnicraft@evex-configuration/playbooks/edx-west/stage-worker.yml,1,0,0,0,0,0,1
2019-03-09 02:13:52.704386, /home/brokenquark/repo-ansi/ovnicraft@evex-configuration/playbooks/edx-west/stage-notifier-only.yml,1,0,0,0,0,0,1
2019-03-09 02:13:52.844108, /home/brokenquark/repo-ansi/ovnicraft@evex-configuration/playbooks/edx-east/edx_notifier.yml,5,0,0,0,0,0,5
2019-03-09 02:13:52.888889, /home/brokenquark/repo-ansi/ovnicraft@evex-configuration/playbooks/secure_example/vars/edxapp_ref_custom_vars.yml,2,0,0,0,0,0,2
2019-03-09 02:13:52.942597, /home/brokenquark/repo-ansi/ovnicraft@evex-configuration/playbooks/secure_example/vars/edxapp_ref_vars.yml,34,0,0,0,0,0,34
2019-03-09 02:13:52.946312, /home/brokenquark/repo-ansi/ovnicraft@evex-configuration/playbooks/secure_example/vars/edxapp_ref_users.yml,2,0,0,0,0,0,2
2019-03-09 02:14:05.718986, /home/brokenquark/repo-ansi/pdehaye@theming-configuration/playbooks/edx_notifier.yml,5,0,0,0,0,0,5
2019-03-09 02:14:05.732867, /home/brokenquark/repo-ansi/pdehaye@theming-configuration/playbooks/roles/common/tasks/create_users.yml,1,0,0,0,0,0,1
2019-03-09 02:14:05.745637, /home/brokenquark/repo-ansi/pdehaye@theming-configuration/playbooks/roles/common/tasks/main.yml,1,0,0,0,0,0,1
2019-03-09 02:14:05.760363, /home/brokenquark/repo-ansi/pdehaye@theming-configuration/playbooks/roles/edxlocal/tasks/main.yml,2,0,0,0,0,0,2
2019-03-09 02:14:05.776935, /home/brokenquark/repo-ansi/pdehaye@theming-configuration/playbooks/roles/xserver/tasks/main.yml,1,0,0,0,0,0,1
2019-03-09 02:14:05.783845, /home/brokenquark/repo-ansi/pdehaye@theming-configuration/playbooks/roles/forum/vars/main.yml,4,0,0,0,0,0,4
2019-03-09 02:14:05.808798, /home/brokenquark/repo-ansi/pdehaye@theming-configuration/playbooks/roles/ora/vars/main.yml,5,1,0,0,0,0,6
2019-03-09 02:14:05.859869, /home/brokenquark/repo-ansi/pdehaye@theming-configuration/playbooks/roles/oraclejdk/vars/main.yml,0,0,1,0,0,0,1
2019-03-09 02:14:05.877498, /home/brokenquark/repo-ansi/pdehaye@theming-configuration/playbooks/roles/notifier/vars/main.yml,7,1,0,0,0,0,8
2019-03-09 02:14:05.908663, /home/brokenquark/repo-ansi/pdehaye@theming-configuration/playbooks/roles/mongo/tasks/main.yml,1,0,0,0,0,0,1
2019-03-09 02:14:05.951176, /home/brokenquark/repo-ansi/pdehaye@theming-configuration/playbooks/roles/edxapp/vars/main.yml,61,15,0,0,0,0,76
2019-03-09 02:14:05.963789, /home/brokenquark/repo-ansi/pdehaye@theming-configuration/playbooks/roles/edxapp/tasks/collect_static.yml,5,0,0,0,0,0,5
2019-03-09 02:14:05.980257, /home/brokenquark/repo-ansi/pdehaye@theming-configuration/playbooks/roles/edxapp/tasks/ruby.yml,1,0,0,0,0,0,1
2019-03-09 02:14:06.009963, /home/brokenquark/repo-ansi/pdehaye@theming-configuration/playbooks/roles/edxapp/tasks/deploy.yml,3,0,0,0,2,0,5
2019-03-09 02:14:06.031570, /home/brokenquark/repo-ansi/pdehaye@theming-configuration/playbooks/roles/jenkins/vars/main.yml,1,0,0,0,0,0,1
2019-03-09 02:14:06.040823, /home/brokenquark/repo-ansi/pdehaye@theming-configuration/playbooks/roles/jenkins/tasks/config-backup.yml,2,0,0,0,0,0,2
2019-03-09 02:14:06.049384, /home/brokenquark/repo-ansi/pdehaye@theming-configuration/playbooks/roles/jenkins/tasks/jenkins.yml,4,0,0,0,0,0,4
2019-03-09 02:14:06.053419, /home/brokenquark/repo-ansi/pdehaye@theming-configuration/playbooks/roles/rabbitmq/vars/main.yml,3,0,1,0,0,0,4
2019-03-09 02:14:06.061574, /home/brokenquark/repo-ansi/pdehaye@theming-configuration/playbooks/roles/rabbitmq/tasks/main.yml,1,0,0,0,1,0,2
2019-03-09 02:14:06.063469, /home/brokenquark/repo-ansi/pdehaye@theming-configuration/playbooks/roles/discern/vars/main.yml,1,0,0,0,0,0,1
2019-03-09 02:14:06.079410, /home/brokenquark/repo-ansi/pdehaye@theming-configuration/playbooks/roles/discern/tasks/main.yml,0,0,0,0,1,0,1
2019-03-09 02:14:06.108759, /home/brokenquark/repo-ansi/pdehaye@theming-configuration/playbooks/roles/xqueue/vars/main.yml,3,1,0,0,0,0,4
2019-03-09 02:14:06.130130, /home/brokenquark/repo-ansi/pdehaye@theming-configuration/playbooks/roles/nginx/vars/main.yml,1,0,0,0,0,0,1
2019-03-09 02:14:06.142833, /home/brokenquark/repo-ansi/pdehaye@theming-configuration/playbooks/roles/shibboleth/vars/main.yml,3,0,1,0,0,0,4
2019-03-09 02:14:06.210723, /home/brokenquark/repo-ansi/pdehaye@theming-configuration/playbooks/edx-east/edx_notifier.yml,5,0,0,0,0,0,5
2019-03-09 02:14:06.219019, /home/brokenquark/repo-ansi/pdehaye@theming-configuration/playbooks/secure_example/vars/edxapp_ref_custom_vars.yml,2,0,0,0,0,0,2
2019-03-09 02:14:06.250411, /home/brokenquark/repo-ansi/pdehaye@theming-configuration/playbooks/secure_example/vars/edxapp_ref_vars.yml,34,0,0,0,0,0,34
2019-03-09 02:14:06.252289, /home/brokenquark/repo-ansi/pdehaye@theming-configuration/playbooks/secure_example/vars/edxapp_ref_users.yml,2,0,0,0,0,0,2
2019-03-09 02:14:06.304144, /home/brokenquark/repo-ansi/pedrorib@istx/playbooks/roles/jenkins_master/defaults/main.yml,1,0,1,0,0,0,2
2019-03-09 02:14:06.318643, /home/brokenquark/repo-ansi/pedrorib@istx/playbooks/roles/jenkins_master/tasks/main.yml,0,0,0,0,4,0,4
2019-03-09 02:14:06.331243, /home/brokenquark/repo-ansi/pedrorib@istx/playbooks/roles/common/defaults/main.yml,11,1,2,0,0,0,14
2019-03-09 02:14:06.341433, /home/brokenquark/repo-ansi/pedrorib@istx/playbooks/roles/common/tasks/main.yml,0,0,0,0,1,0,1
2019-03-09 02:14:06.361343, /home/brokenquark/repo-ansi/pedrorib@istx/playbooks/roles/harprofiler/defaults/main.yml,1,0,0,0,0,0,1
2019-03-09 02:14:06.411219, /home/brokenquark/repo-ansi/pedrorib@istx/playbooks/roles/gerrit/defaults/main.yml,1,0,0,0,0,0,1
2019-03-09 02:14:06.436068, /home/brokenquark/repo-ansi/pedrorib@istx/playbooks/roles/xserver/defaults/main.yml,2,0,0,0,0,0,2
2019-03-09 02:14:06.458603, /home/brokenquark/repo-ansi/pedrorib@istx/playbooks/roles/test_build_server/defaults/main.yml,1,0,0,0,0,0,1
2019-03-09 02:14:06.468797, /home/brokenquark/repo-ansi/pedrorib@istx/playbooks/roles/aws/defaults/main.yml,3,0,1,0,1,1,6
2019-03-09 02:14:06.480448, /home/brokenquark/repo-ansi/pedrorib@istx/playbooks/roles/aws/tasks/main.yml,1,0,0,0,2,0,3
2019-03-09 02:14:06.490668, /home/brokenquark/repo-ansi/pedrorib@istx/playbooks/roles/forum/defaults/main.yml,3,0,0,1,0,0,4
2019-03-09 02:14:06.534351, /home/brokenquark/repo-ansi/pedrorib@istx/playbooks/roles/ora/defaults/main.yml,7,0,0,0,0,0,7
2019-03-09 02:14:06.561906, /home/brokenquark/repo-ansi/pedrorib@istx/playbooks/roles/redis/defaults/main.yml,1,1,0,0,0,0,2
2019-03-09 02:14:06.568115, /home/brokenquark/repo-ansi/pedrorib@istx/playbooks/roles/elasticsearch/defaults/main.yml,1,0,1,0,0,0,2
2019-03-09 02:14:06.583420, /home/brokenquark/repo-ansi/pedrorib@istx/playbooks/roles/antivirus/defaults/main.yml,1,0,0,0,0,0,1
2019-03-09 02:14:06.604966, /home/brokenquark/repo-ansi/pedrorib@istx/playbooks/roles/flower/defaults/main.yml,4,0,0,1,0,0,5
2019-03-09 02:14:06.616437, /home/brokenquark/repo-ansi/pedrorib@istx/playbooks/roles/gh_mirror/defaults/main.yml,1,0,0,0,0,0,1
2019-03-09 02:14:06.627246, /home/brokenquark/repo-ansi/pedrorib@istx/playbooks/roles/devpi/defaults/main.yml,2,0,0,0,0,0,2
2019-03-09 02:14:06.656561, /home/brokenquark/repo-ansi/pedrorib@istx/playbooks/roles/user/defaults/main.yml,0,0,0,0,1,0,1
2019-03-09 02:14:06.690335, /home/brokenquark/repo-ansi/pedrorib@istx/playbooks/roles/ecommerce/defaults/main.yml,7,0,0,0,0,0,7
2019-03-09 02:14:06.710431, /home/brokenquark/repo-ansi/pedrorib@istx/playbooks/roles/newrelic/tasks/newrelic-logwatcher.yml,1,0,0,0,0,0,1
2019-03-09 02:14:06.726669, /home/brokenquark/repo-ansi/pedrorib@istx/playbooks/roles/newrelic/meta/main.yml,2,0,0,0,0,0,2
2019-03-09 02:14:06.734884, /home/brokenquark/repo-ansi/pedrorib@istx/playbooks/roles/alton/defaults/main.yml,6,0,0,0,0,0,6
2019-03-09 02:14:06.768065, /home/brokenquark/repo-ansi/pedrorib@istx/playbooks/roles/gluster/tasks/main.yml,0,0,0,0,1,0,1
2019-03-09 02:14:06.777603, /home/brokenquark/repo-ansi/pedrorib@istx/playbooks/roles/certs/defaults/main.yml,4,0,0,0,0,0,4
2019-03-09 02:14:06.804922, /home/brokenquark/repo-ansi/pedrorib@istx/playbooks/roles/demo/defaults/main.yml,6,0,0,0,0,0,6
2019-03-09 02:14:06.814998, /home/brokenquark/repo-ansi/pedrorib@istx/playbooks/roles/oraclejdk/defaults/main.yml,0,0,1,0,0,0,1
2019-03-09 02:14:06.825003, /home/brokenquark/repo-ansi/pedrorib@istx/playbooks/roles/splunkforwarder/defaults/main.yml,0,1,0,0,0,0,1
2019-03-09 02:14:06.833693, /home/brokenquark/repo-ansi/pedrorib@istx/playbooks/roles/splunkforwarder/tasks/main.yml,1,0,0,0,0,0,1
2019-03-09 02:14:06.848769, /home/brokenquark/repo-ansi/pedrorib@istx/playbooks/roles/notifier/defaults/main.yml,2,2,0,0,0,0,4
2019-03-09 02:14:06.875775, /home/brokenquark/repo-ansi/pedrorib@istx/playbooks/roles/edx_ansible/defaults/main.yml,1,0,0,0,0,0,1
2019-03-09 02:14:06.897578, /home/brokenquark/repo-ansi/pedrorib@istx/playbooks/roles/snort/defaults/main.yml,0,0,2,0,0,1,3
2019-03-09 02:14:06.918914, /home/brokenquark/repo-ansi/pedrorib@istx/playbooks/roles/mariadb/defaults/main.yml,3,0,0,0,0,0,3
2019-03-09 02:14:06.951395, /home/brokenquark/repo-ansi/pedrorib@istx/playbooks/roles/minos/meta/main.yml,1,0,0,0,0,0,1
2019-03-09 02:14:06.969987, /home/brokenquark/repo-ansi/pedrorib@istx/playbooks/roles/gitreload/defaults/main.yml,1,0,0,0,0,0,1
2019-03-09 02:14:06.994415, /home/brokenquark/repo-ansi/pedrorib@istx/playbooks/roles/locust/defaults/main.yml,1,0,0,0,0,0,1
2019-03-09 02:14:07.013568, /home/brokenquark/repo-ansi/pedrorib@istx/playbooks/roles/s3fs/defaults/main.yml,0,0,1,0,0,0,1
2019-03-09 02:14:07.026250, /home/brokenquark/repo-ansi/pedrorib@istx/playbooks/roles/mongo/defaults/main.yml,7,0,1,0,0,0,8
2019-03-09 02:14:07.153435, /home/brokenquark/repo-ansi/pedrorib@istx/playbooks/roles/edxapp/defaults/main.yml,16,1,2,0,1,0,20
2019-03-09 02:14:07.204729, /home/brokenquark/repo-ansi/pedrorib@istx/playbooks/roles/edxapp/tasks/deploy.yml,0,0,0,0,3,0,3
2019-03-09 02:14:07.237493, /home/brokenquark/repo-ansi/pedrorib@istx/playbooks/roles/edx_notes_api/defaults/main.yml,3,0,0,0,0,0,3
2019-03-09 02:14:07.266718, /home/brokenquark/repo-ansi/pedrorib@istx/playbooks/roles/rabbitmq/defaults/main.yml,5,0,2,0,0,1,8
2019-03-09 02:14:07.281902, /home/brokenquark/repo-ansi/pedrorib@istx/playbooks/roles/rabbitmq/tasks/main.yml,1,0,0,0,1,0,2
2019-03-09 02:14:07.301017, /home/brokenquark/repo-ansi/pedrorib@istx/playbooks/roles/insights/defaults/main.yml,7,0,1,0,0,0,8
2019-03-09 02:14:07.320863, /home/brokenquark/repo-ansi/pedrorib@istx/playbooks/roles/supervisor/defaults/main.yml,1,0,0,0,0,0,1
2019-03-09 02:14:07.336498, /home/brokenquark/repo-ansi/pedrorib@istx/playbooks/roles/browsers/defaults/main.yml,0,0,1,0,0,1,2
2019-03-09 02:14:07.347627, /home/brokenquark/repo-ansi/pedrorib@istx/playbooks/roles/nltk/defaults/main.yml,0,0,3,0,0,3,6
2019-03-09 02:14:07.367042, /home/brokenquark/repo-ansi/pedrorib@istx/playbooks/roles/analytics_api/defaults/main.yml,8,0,0,0,0,0,8
2019-03-09 02:14:07.394574, /home/brokenquark/repo-ansi/pedrorib@istx/playbooks/roles/discern/defaults/main.yml,3,0,1,0,0,1,5
2019-03-09 02:14:07.416909, /home/brokenquark/repo-ansi/pedrorib@istx/playbooks/roles/discern/tasks/main.yml,0,0,0,0,1,0,1
2019-03-09 02:14:07.506434, /home/brokenquark/repo-ansi/pedrorib@istx/playbooks/roles/jenkins_worker/defaults/main.yml,1,0,0,0,0,1,2
2019-03-09 02:14:07.519354, /home/brokenquark/repo-ansi/pedrorib@istx/playbooks/roles/jenkins_worker/tasks/system.yml,0,0,0,0,2,0,2
2019-03-09 02:14:07.538249, /home/brokenquark/repo-ansi/pedrorib@istx/playbooks/roles/datadog/defaults/main.yml,1,0,0,0,0,0,1
2019-03-09 02:14:07.556611, /home/brokenquark/repo-ansi/pedrorib@istx/playbooks/roles/xqueue/defaults/main.yml,5,0,0,0,0,0,5
2019-03-09 02:14:07.584183, /home/brokenquark/repo-ansi/pedrorib@istx/playbooks/roles/nginx/defaults/main.yml,2,0,0,0,0,0,2
2019-03-09 02:14:07.604339, /home/brokenquark/repo-ansi/pedrorib@istx/playbooks/roles/shibboleth/defaults/main.yml,3,0,1,0,0,0,4
2019-03-09 02:14:07.611617, /home/brokenquark/repo-ansi/pedrorib@istx/playbooks/roles/jscover/defaults/main.yml,0,0,1,0,0,0,1
2019-03-09 02:14:07.636670, /home/brokenquark/repo-ansi/pedrorib@istx/playbooks/roles/local_dev/defaults/main.yml,1,0,0,0,0,0,1
2019-03-09 02:14:07.648473, /home/brokenquark/repo-ansi/pedrorib@istx/playbooks/roles/cassandra/defaults/main.yml,1,0,0,0,0,0,1
2019-03-09 02:14:07.657188, /home/brokenquark/repo-ansi/pedrorib@istx/playbooks/roles/cassandra/tasks/main.yml,0,0,1,0,0,0,1
2019-03-09 02:14:07.675858, /home/brokenquark/repo-ansi/pedrorib@istx/playbooks/edx-west/stage-worker.yml,1,0,0,0,0,0,1
2019-03-09 02:14:07.736411, /home/brokenquark/repo-ansi/pedrorib@istx/playbooks/edx-west/stage-notifier-only.yml,1,0,0,0,0,0,1
2019-03-09 02:14:07.875241, /home/brokenquark/repo-ansi/pedrorib@istx/playbooks/edx-east/edx_provision.yml,3,0,0,0,0,0,3
2019-03-09 02:14:07.882921, /home/brokenquark/repo-ansi/pedrorib@istx/playbooks/edx-east/add-ubuntu-key.yml,1,0,0,0,0,0,1
2019-03-09 02:14:07.913784, /home/brokenquark/repo-ansi/pedrorib@istx/playbooks/edx-east/remove-ubuntu-key.yml,1,0,0,0,0,0,1
2019-03-09 02:14:07.936340, /home/brokenquark/repo-ansi/pedrorib@istx/playbooks/edx-east/edx_notifier.yml,5,0,0,0,0,0,5
2019-03-09 02:14:08.004245, /home/brokenquark/repo-ansi/pedrorib@istx/playbooks/edx-east/ora2.yml,3,0,0,0,0,0,3
2019-03-09 02:14:20.042382, /home/brokenquark/repo-ansi/quarkslab@irma/ansible/playbooks/group_vars/brain.yml,0,0,0,1,0,0,1
2019-03-09 02:14:20.045323, /home/brokenquark/repo-ansi/quarkslab@irma/ansible/playbooks/group_vars/windows.yml,2,0,0,0,0,0,2
2019-03-09 02:14:20.059440, /home/brokenquark/repo-ansi/quarkslab@irma/ansible/playbooks/group_vars/probe.yml,2,0,0,0,0,0,2
2019-03-09 02:14:20.128974, /home/brokenquark/repo-ansi/quarkslab@irma/ansible/playbooks/group_vars/all.yml,22,0,0,0,0,0,22
2019-03-09 02:14:20.138828, /home/brokenquark/repo-ansi/quarkslab@irma/ansible/playbooks/group_vars/sql-server.yml,2,2,0,0,0,0,4
2019-03-09 02:14:22.559980, /home/brokenquark/repo-ansi/rcbops@ansible-lxc-rpc/rpc_deployment/playbooks/os-service-config-update.yml,1,0,0,0,0,0,1
2019-03-09 02:14:22.563262, /home/brokenquark/repo-ansi/rcbops@ansible-lxc-rpc/rpc_deployment/playbooks/infrastructure/memcached-install.yml,1,0,0,0,0,0,1
2019-03-09 02:14:22.564696, /home/brokenquark/repo-ansi/rcbops@ansible-lxc-rpc/rpc_deployment/playbooks/infrastructure/rabbit-bootstrap.yml,1,0,0,0,0,0,1
2019-03-09 02:14:22.566062, /home/brokenquark/repo-ansi/rcbops@ansible-lxc-rpc/rpc_deployment/playbooks/infrastructure/rsyslog-config.yml,1,0,0,0,0,0,1
2019-03-09 02:14:22.567958, /home/brokenquark/repo-ansi/rcbops@ansible-lxc-rpc/rpc_deployment/playbooks/infrastructure/rabbit-config.yml,1,0,0,0,0,0,1
2019-03-09 02:14:22.569309, /home/brokenquark/repo-ansi/rcbops@ansible-lxc-rpc/rpc_deployment/playbooks/infrastructure/logstash-config.yml,1,0,0,0,0,0,1
2019-03-09 02:14:22.571434, /home/brokenquark/repo-ansi/rcbops@ansible-lxc-rpc/rpc_deployment/playbooks/infrastructure/galera-config.yml,1,0,0,0,0,0,1
2019-03-09 02:14:22.572911, /home/brokenquark/repo-ansi/rcbops@ansible-lxc-rpc/rpc_deployment/playbooks/infrastructure/galera-add-node.yml,1,0,0,0,0,0,1
2019-03-09 02:14:22.574642, /home/brokenquark/repo-ansi/rcbops@ansible-lxc-rpc/rpc_deployment/playbooks/infrastructure/kibana-install.yml,1,0,0,0,0,0,1
2019-03-09 02:14:22.575979, /home/brokenquark/repo-ansi/rcbops@ansible-lxc-rpc/rpc_deployment/playbooks/infrastructure/galera-bootstrap.yml,1,0,0,0,0,0,1
2019-03-09 02:14:22.577299, /home/brokenquark/repo-ansi/rcbops@ansible-lxc-rpc/rpc_deployment/playbooks/infrastructure/galera-remove.yml,1,0,0,0,0,0,1
2019-03-09 02:14:22.580464, /home/brokenquark/repo-ansi/rcbops@ansible-lxc-rpc/rpc_deployment/playbooks/infrastructure/logstash-install.yml,1,0,0,0,0,0,1
2019-03-09 02:14:22.581760, /home/brokenquark/repo-ansi/rcbops@ansible-lxc-rpc/rpc_deployment/playbooks/infrastructure/galera-stop.yml,1,0,0,0,0,0,1
2019-03-09 02:14:22.585837, /home/brokenquark/repo-ansi/rcbops@ansible-lxc-rpc/rpc_deployment/playbooks/infrastructure/es2unix-install.yml,1,0,0,0,0,0,1
2019-03-09 02:14:22.587147, /home/brokenquark/repo-ansi/rcbops@ansible-lxc-rpc/rpc_deployment/playbooks/infrastructure/rabbit-remove.yml,1,0,0,0,0,0,1
2019-03-09 02:14:22.588700, /home/brokenquark/repo-ansi/rcbops@ansible-lxc-rpc/rpc_deployment/playbooks/infrastructure/rabbit-add-node.yml,1,0,0,0,0,0,1
2019-03-09 02:14:22.590691, /home/brokenquark/repo-ansi/rcbops@ansible-lxc-rpc/rpc_deployment/playbooks/infrastructure/rsyslog-install.yml,1,0,0,0,0,0,1
2019-03-09 02:14:22.593698, /home/brokenquark/repo-ansi/rcbops@ansible-lxc-rpc/rpc_deployment/playbooks/infrastructure/galera-post-config.yml,2,0,0,0,0,0,2
2019-03-09 02:14:22.595671, /home/brokenquark/repo-ansi/rcbops@ansible-lxc-rpc/rpc_deployment/playbooks/infrastructure/elasticsearch-install.yml,1,0,0,0,0,0,1
2019-03-09 02:14:22.597399, /home/brokenquark/repo-ansi/rcbops@ansible-lxc-rpc/rpc_deployment/playbooks/infrastructure/haproxy-install.yml,1,0,0,0,0,0,1
2019-03-09 02:14:22.598731, /home/brokenquark/repo-ansi/rcbops@ansible-lxc-rpc/rpc_deployment/playbooks/infrastructure/rsyslog-stop.yml,1,0,0,0,0,0,1
2019-03-09 02:14:22.602982, /home/brokenquark/repo-ansi/rcbops@ansible-lxc-rpc/rpc_deployment/playbooks/monitoring/raxmon_cli.yml,1,0,0,0,0,0,1
2019-03-09 02:14:22.614543, /home/brokenquark/repo-ansi/rcbops@ansible-lxc-rpc/rpc_deployment/playbooks/monitoring/swift_maas.yml,5,0,1,0,0,0,6
2019-03-09 02:14:22.643738, /home/brokenquark/repo-ansi/rcbops@ansible-lxc-rpc/rpc_deployment/playbooks/monitoring/maas_remote.yml,9,0,9,0,0,0,18
2019-03-09 02:14:22.647631, /home/brokenquark/repo-ansi/rcbops@ansible-lxc-rpc/rpc_deployment/playbooks/monitoring/raxmon_agent.yml,2,0,0,0,0,0,2
2019-03-09 02:14:22.657046, /home/brokenquark/repo-ansi/rcbops@ansible-lxc-rpc/rpc_deployment/playbooks/monitoring/maas_dell_hardware.yml,3,0,0,0,0,0,3
2019-03-09 02:14:22.711406, /home/brokenquark/repo-ansi/rcbops@ansible-lxc-rpc/rpc_deployment/playbooks/monitoring/maas_local.yml,27,0,0,0,0,0,27
2019-03-09 02:14:22.714827, /home/brokenquark/repo-ansi/rcbops@ansible-lxc-rpc/rpc_deployment/playbooks/setup/archive-container.yml,2,0,0,0,0,0,2
2019-03-09 02:14:22.716836, /home/brokenquark/repo-ansi/rcbops@ansible-lxc-rpc/rpc_deployment/playbooks/setup/restart-containers.yml,1,0,0,0,0,0,1
2019-03-09 02:14:22.729307, /home/brokenquark/repo-ansi/rcbops@ansible-lxc-rpc/rpc_deployment/playbooks/setup/deploy-archived-container.yml,1,0,0,0,0,0,1
2019-03-09 02:14:22.730751, /home/brokenquark/repo-ansi/rcbops@ansible-lxc-rpc/rpc_deployment/playbooks/setup/containers-common.yml,1,0,0,0,0,0,1
2019-03-09 02:14:22.732941, /home/brokenquark/repo-ansi/rcbops@ansible-lxc-rpc/rpc_deployment/playbooks/setup/clone-container.yml,1,0,0,0,0,0,1
2019-03-09 02:14:22.735086, /home/brokenquark/repo-ansi/rcbops@ansible-lxc-rpc/rpc_deployment/playbooks/setup/destroy-containers.yml,1,0,0,0,0,0,1
2019-03-09 02:14:22.738237, /home/brokenquark/repo-ansi/rcbops@ansible-lxc-rpc/rpc_deployment/playbooks/setup/containers-setup.yml,1,0,0,0,0,0,1
2019-03-09 02:14:22.739896, /home/brokenquark/repo-ansi/rcbops@ansible-lxc-rpc/rpc_deployment/playbooks/setup/setup-common.yml,1,0,0,0,0,0,1
2019-03-09 02:14:22.741770, /home/brokenquark/repo-ansi/rcbops@ansible-lxc-rpc/rpc_deployment/playbooks/setup/host-network-setup.yml,1,0,0,0,0,0,1
2019-03-09 02:14:22.743801, /home/brokenquark/repo-ansi/rcbops@ansible-lxc-rpc/rpc_deployment/playbooks/setup/build-containers.yml,1,0,0,0,0,0,1
2019-03-09 02:14:22.745183, /home/brokenquark/repo-ansi/rcbops@ansible-lxc-rpc/rpc_deployment/playbooks/setup/upgrade-safe.yml,1,0,0,0,0,0,1
2019-03-09 02:14:22.748839, /home/brokenquark/repo-ansi/rcbops@ansible-lxc-rpc/rpc_deployment/playbooks/openstack/swift-account.yml,1,0,0,0,0,0,1
2019-03-09 02:14:22.750899, /home/brokenquark/repo-ansi/rcbops@ansible-lxc-rpc/rpc_deployment/playbooks/openstack/swift-object.yml,1,0,0,0,0,0,1
2019-03-09 02:14:22.757664, /home/brokenquark/repo-ansi/rcbops@ansible-lxc-rpc/rpc_deployment/playbooks/openstack/cinder-api.yml,4,0,0,0,0,0,4
2019-03-09 02:14:22.760756, /home/brokenquark/repo-ansi/rcbops@ansible-lxc-rpc/rpc_deployment/playbooks/openstack/neutron-common.yml,1,0,0,0,0,0,1
2019-03-09 02:14:22.765673, /home/brokenquark/repo-ansi/rcbops@ansible-lxc-rpc/rpc_deployment/playbooks/openstack/keystone-local-keys.yml,3,0,0,0,0,0,3
2019-03-09 02:14:22.772351, /home/brokenquark/repo-ansi/rcbops@ansible-lxc-rpc/rpc_deployment/playbooks/openstack/nova-common.yml,1,0,0,0,0,0,1
2019-03-09 02:14:22.777047, /home/brokenquark/repo-ansi/rcbops@ansible-lxc-rpc/rpc_deployment/playbooks/openstack/keystone.yml,2,0,0,0,0,0,2
2019-03-09 02:14:22.782175, /home/brokenquark/repo-ansi/rcbops@ansible-lxc-rpc/rpc_deployment/playbooks/openstack/heat-api-cfn.yml,2,0,0,0,0,0,2
2019-03-09 02:14:22.789119, /home/brokenquark/repo-ansi/rcbops@ansible-lxc-rpc/rpc_deployment/playbooks/openstack/nova-compute-keys.yml,4,0,0,0,0,0,4
2019-03-09 02:14:22.794294, /home/brokenquark/repo-ansi/rcbops@ansible-lxc-rpc/rpc_deployment/playbooks/openstack/nova-api-os-compute.yml,4,0,0,0,0,0,4
2019-03-09 02:14:22.797476, /home/brokenquark/repo-ansi/rcbops@ansible-lxc-rpc/rpc_deployment/playbooks/openstack/nova-scheduler.yml,1,0,0,0,0,0,1
2019-03-09 02:14:22.800419, /home/brokenquark/repo-ansi/rcbops@ansible-lxc-rpc/rpc_deployment/playbooks/openstack/horizon.yml,2,0,0,0,0,0,2
2019-03-09 02:14:22.802060, /home/brokenquark/repo-ansi/rcbops@ansible-lxc-rpc/rpc_deployment/playbooks/openstack/keystone-add-users.yml,1,0,0,0,0,0,1
2019-03-09 02:14:22.806134, /home/brokenquark/repo-ansi/rcbops@ansible-lxc-rpc/rpc_deployment/playbooks/openstack/swift-build-rings.yml,3,0,0,0,0,0,3
2019-03-09 02:14:22.810280, /home/brokenquark/repo-ansi/rcbops@ansible-lxc-rpc/rpc_deployment/playbooks/openstack/nova-spice-console.yml,2,0,0,0,0,0,2
2019-03-09 02:14:22.815356, /home/brokenquark/repo-ansi/rcbops@ansible-lxc-rpc/rpc_deployment/playbooks/openstack/neutron-server.yml,2,0,0,0,0,0,2
2019-03-09 02:14:22.817726, /home/brokenquark/repo-ansi/rcbops@ansible-lxc-rpc/rpc_deployment/playbooks/openstack/cinder-scheduler.yml,1,0,0,0,0,0,1
2019-03-09 02:14:22.823465, /home/brokenquark/repo-ansi/rcbops@ansible-lxc-rpc/rpc_deployment/playbooks/openstack/nova-api-ec2.yml,4,0,0,0,0,0,4
2019-03-09 02:14:22.827786, /home/brokenquark/repo-ansi/rcbops@ansible-lxc-rpc/rpc_deployment/playbooks/openstack/nova-compute.yml,1,0,0,0,0,0,1
2019-03-09 02:14:22.829973, /home/brokenquark/repo-ansi/rcbops@ansible-lxc-rpc/rpc_deployment/playbooks/openstack/nova-cert.yml,1,0,0,0,0,0,1
2019-03-09 02:14:22.832003, /home/brokenquark/repo-ansi/rcbops@ansible-lxc-rpc/rpc_deployment/playbooks/openstack/neutron-metadata-agent.yml,1,0,0,0,0,0,1
2019-03-09 02:14:22.839305, /home/brokenquark/repo-ansi/rcbops@ansible-lxc-rpc/rpc_deployment/playbooks/openstack/horizon-ssl.yml,3,0,0,0,0,0,3
2019-03-09 02:14:22.843950, /home/brokenquark/repo-ansi/rcbops@ansible-lxc-rpc/rpc_deployment/playbooks/openstack/keystone-common.yml,1,0,0,0,0,0,1
2019-03-09 02:14:22.847125, /home/brokenquark/repo-ansi/rcbops@ansible-lxc-rpc/rpc_deployment/playbooks/openstack/glance-common.yml,1,0,0,0,0,0,1
2019-03-09 02:14:22.851432, /home/brokenquark/repo-ansi/rcbops@ansible-lxc-rpc/rpc_deployment/playbooks/openstack/utility-common.yml,1,0,0,0,0,0,1
2019-03-09 02:14:22.858219, /home/brokenquark/repo-ansi/rcbops@ansible-lxc-rpc/rpc_deployment/playbooks/openstack/cinder-common.yml,1,0,0,0,0,0,1
2019-03-09 02:14:22.860350, /home/brokenquark/repo-ansi/rcbops@ansible-lxc-rpc/rpc_deployment/playbooks/openstack/heat-common.yml,1,0,0,0,0,0,1
2019-03-09 02:14:22.862320, /home/brokenquark/repo-ansi/rcbops@ansible-lxc-rpc/rpc_deployment/playbooks/openstack/swift-container.yml,1,0,0,0,0,0,1
2019-03-09 02:14:22.865810, /home/brokenquark/repo-ansi/rcbops@ansible-lxc-rpc/rpc_deployment/playbooks/openstack/horizon-common.yml,1,0,0,0,0,0,1
2019-03-09 02:14:22.869057, /home/brokenquark/repo-ansi/rcbops@ansible-lxc-rpc/rpc_deployment/playbooks/openstack/swift-proxy.yml,2,0,0,0,0,0,2
2019-03-09 02:14:22.879320, /home/brokenquark/repo-ansi/rcbops@ansible-lxc-rpc/rpc_deployment/playbooks/openstack/keystone-add-all-services.yml,11,0,0,0,0,0,11
2019-03-09 02:14:22.884433, /home/brokenquark/repo-ansi/rcbops@ansible-lxc-rpc/rpc_deployment/playbooks/openstack/swift-common.yml,1,0,0,0,0,0,1
2019-03-09 02:14:22.886482, /home/brokenquark/repo-ansi/rcbops@ansible-lxc-rpc/rpc_deployment/playbooks/openstack/heat-engine.yml,1,0,0,0,0,0,1
2019-03-09 02:14:22.890784, /home/brokenquark/repo-ansi/rcbops@ansible-lxc-rpc/rpc_deployment/playbooks/openstack/glance-api.yml,3,0,0,0,0,0,3
2019-03-09 02:14:22.894354, /home/brokenquark/repo-ansi/rcbops@ansible-lxc-rpc/rpc_deployment/playbooks/openstack/glance-registry.yml,1,0,0,0,0,0,1
2019-03-09 02:14:22.896510, /home/brokenquark/repo-ansi/rcbops@ansible-lxc-rpc/rpc_deployment/playbooks/openstack/neutron-dhcp-agent.yml,1,0,0,0,0,0,1
2019-03-09 02:14:22.898812, /home/brokenquark/repo-ansi/rcbops@ansible-lxc-rpc/rpc_deployment/playbooks/openstack/swift-storage.yml,1,0,0,0,0,0,1
2019-03-09 02:14:22.902587, /home/brokenquark/repo-ansi/rcbops@ansible-lxc-rpc/rpc_deployment/playbooks/openstack/heat-api.yml,2,0,0,0,0,0,2
2019-03-09 02:14:22.906282, /home/brokenquark/repo-ansi/rcbops@ansible-lxc-rpc/rpc_deployment/playbooks/openstack/heat-api-cloudwatch.yml,1,0,0,0,0,0,1
2019-03-09 02:14:22.908112, /home/brokenquark/repo-ansi/rcbops@ansible-lxc-rpc/rpc_deployment/playbooks/openstack/rpc-support-common.yml,1,0,0,0,0,0,1
2019-03-09 02:14:22.910413, /home/brokenquark/repo-ansi/rcbops@ansible-lxc-rpc/rpc_deployment/playbooks/openstack/neutron-metering-agent.yml,1,0,0,0,0,0,1
2019-03-09 02:14:22.913514, /home/brokenquark/repo-ansi/rcbops@ansible-lxc-rpc/rpc_deployment/playbooks/openstack/neutron-l3-agent.yml,1,0,0,0,0,0,1
2019-03-09 02:14:22.915757, /home/brokenquark/repo-ansi/rcbops@ansible-lxc-rpc/rpc_deployment/playbooks/openstack/nova-api-metadata.yml,1,0,0,0,0,0,1
2019-03-09 02:14:22.918584, /home/brokenquark/repo-ansi/rcbops@ansible-lxc-rpc/rpc_deployment/playbooks/openstack/cinder-volume.yml,1,0,0,0,0,0,1
2019-03-09 02:14:22.926410, /home/brokenquark/repo-ansi/rcbops@ansible-lxc-rpc/rpc_deployment/playbooks/openstack/rpc-support-api.yml,3,0,0,0,0,0,3
2019-03-09 02:14:22.928865, /home/brokenquark/repo-ansi/rcbops@ansible-lxc-rpc/rpc_deployment/playbooks/openstack/nova-conductor.yml,1,0,0,0,0,0,1
2019-03-09 02:14:22.931402, /home/brokenquark/repo-ansi/rcbops@ansible-lxc-rpc/rpc_deployment/playbooks/openstack/rpc-support-holland.yml,1,0,0,0,0,0,1
2019-03-09 02:14:22.933855, /home/brokenquark/repo-ansi/rcbops@ansible-lxc-rpc/rpc_deployment/playbooks/openstack/neutron-linuxbridge-agent.yml,1,0,0,0,0,0,1
2019-03-09 02:14:31.042062, /home/brokenquark/repo-ansi/rcbops@rpc-openstack/playbooks/deployment-elk.yml,2,0,0,0,0,0,2
2019-03-09 02:14:31.046076, /home/brokenquark/repo-ansi/rcbops@rpc-openstack/playbooks/openstack-flavor-setup.yml,1,0,0,0,0,0,1
2019-03-09 02:14:31.108768, /home/brokenquark/repo-ansi/rcbops@rpc-openstack/playbooks/configure-release.yml,9,0,0,0,0,0,9
2019-03-09 02:14:31.116446, /home/brokenquark/repo-ansi/rcbops@rpc-openstack/playbooks/openstack-image-setup.yml,1,0,0,0,0,0,1
2019-03-09 02:14:31.126764, /home/brokenquark/repo-ansi/rcbops@rpc-openstack/playbooks/openstack-ansible-install.yml,2,0,0,0,0,0,2
2019-03-09 02:14:31.140717, /home/brokenquark/repo-ansi/rcbops@rpc-openstack/playbooks/deployment-osquery.yml,6,0,0,0,0,0,6
2019-03-09 02:14:31.165704, /home/brokenquark/repo-ansi/rcbops@rpc-openstack/playbooks/vars/openstack-service-config.yml,0,0,8,0,0,0,8
2019-03-09 02:14:40.609473, /home/brokenquark/repo-ansi/redhat-performance@satellite-performance/playbooks/common/prepare_host.yaml,1,0,0,0,0,0,1
2019-03-09 02:14:40.627897, /home/brokenquark/repo-ansi/redhat-performance@satellite-performance/playbooks/common/roles/common/tasks/main.yaml,1,0,0,0,0,0,1
2019-03-09 02:14:40.660285, /home/brokenquark/repo-ansi/redhat-performance@satellite-performance/playbooks/common/roles/scalelab-nic-cleanup/tasks/main.yaml,1,0,0,0,0,0,1
2019-03-09 02:14:40.675196, /home/brokenquark/repo-ansi/redhat-performance@satellite-performance/playbooks/docker/docker-purge-storage.yaml,1,0,0,0,0,0,1
2019-03-09 02:14:40.681085, /home/brokenquark/repo-ansi/redhat-performance@satellite-performance/playbooks/docker/docker-containerized.yaml,1,0,0,0,0,0,1
2019-03-09 02:14:40.692393, /home/brokenquark/repo-ansi/redhat-performance@satellite-performance/playbooks/docker/docker-tierdown.yaml,2,0,0,0,0,0,2
2019-03-09 02:14:40.693809, /home/brokenquark/repo-ansi/redhat-performance@satellite-performance/playbooks/docker/docker-recreate-image.yaml,1,0,0,0,0,0,1
2019-03-09 02:14:40.699672, /home/brokenquark/repo-ansi/redhat-performance@satellite-performance/playbooks/docker/docker-host.yaml,1,0,0,0,0,0,1
2019-03-09 02:14:40.702362, /home/brokenquark/repo-ansi/redhat-performance@satellite-performance/playbooks/docker/docker-remove-journal.yaml,1,0,0,0,0,0,1
2019-03-09 02:14:40.704110, /home/brokenquark/repo-ansi/redhat-performance@satellite-performance/playbooks/docker/docker-resurrect.yaml,1,0,0,0,0,0,1
2019-03-09 02:14:40.711357, /home/brokenquark/repo-ansi/redhat-performance@satellite-performance/playbooks/docker/docker-tierup.yaml,1,0,0,0,0,0,1
2019-03-09 02:14:40.717155, /home/brokenquark/repo-ansi/redhat-performance@satellite-performance/playbooks/docker/docker-check.yaml,1,0,0,0,0,0,1
2019-03-09 02:14:40.718571, /home/brokenquark/repo-ansi/redhat-performance@satellite-performance/playbooks/docker/docker-host-atomic.yaml,1,0,0,0,0,0,1
2019-03-09 02:14:40.776732, /home/brokenquark/repo-ansi/redhat-performance@satellite-performance/playbooks/docker/roles/docker-host/tasks/main.yaml,2,0,0,0,0,0,2
2019-03-09 02:14:40.810823, /home/brokenquark/repo-ansi/redhat-performance@satellite-performance/playbooks/satellite/workarounds.yaml,1,0,0,0,0,0,1
2019-03-09 02:14:40.818978, /home/brokenquark/repo-ansi/redhat-performance@satellite-performance/playbooks/satellite/remove-capsules.yaml,1,0,0,0,0,0,1
2019-03-09 02:14:40.820376, /home/brokenquark/repo-ansi/redhat-performance@satellite-performance/playbooks/satellite/client-content.yaml,1,0,0,0,0,0,1
2019-03-09 02:14:40.824885, /home/brokenquark/repo-ansi/redhat-performance@satellite-performance/playbooks/satellite/ec2-cleanup.yaml,1,0,0,0,0,0,1
2019-03-09 02:14:40.826970, /home/brokenquark/repo-ansi/redhat-performance@satellite-performance/playbooks/satellite/healthcheck.yaml,1,0,0,0,0,0,1
2019-03-09 02:14:40.831255, /home/brokenquark/repo-ansi/redhat-performance@satellite-performance/playbooks/satellite/capsules-check.yaml,1,0,0,0,0,0,1
2019-03-09 02:14:40.833298, /home/brokenquark/repo-ansi/redhat-performance@satellite-performance/playbooks/satellite/client-scripts.yaml,1,0,0,0,0,0,1
2019-03-09 02:14:40.834413, /home/brokenquark/repo-ansi/redhat-performance@satellite-performance/playbooks/satellite/10gnic.yaml,1,0,0,0,0,0,1
2019-03-09 02:14:40.843245, /home/brokenquark/repo-ansi/redhat-performance@satellite-performance/playbooks/satellite/remove-satellite.yaml,1,0,0,0,0,0,1
2019-03-09 02:14:40.846440, /home/brokenquark/repo-ansi/redhat-performance@satellite-performance/playbooks/satellite/satellite-remove-hosts.yaml,1,0,0,0,0,0,1
2019-03-09 02:14:40.848534, /home/brokenquark/repo-ansi/redhat-performance@satellite-performance/playbooks/satellite/capsules.yaml,1,0,0,0,0,0,1
2019-03-09 02:14:40.861774, /home/brokenquark/repo-ansi/redhat-performance@satellite-performance/playbooks/satellite/satutils.yaml,13,0,0,0,0,0,13
2019-03-09 02:14:40.864490, /home/brokenquark/repo-ansi/redhat-performance@satellite-performance/playbooks/satellite/installation.yaml,1,0,0,0,0,0,1
2019-03-09 02:14:40.865962, /home/brokenquark/repo-ansi/redhat-performance@satellite-performance/playbooks/satellite/ebtables-flush.yaml,1,0,0,0,0,0,1
2019-03-09 02:14:40.867156, /home/brokenquark/repo-ansi/redhat-performance@satellite-performance/playbooks/satellite/satellite-populate.yaml,1,0,0,0,0,0,1
2019-03-09 02:14:40.965050, /home/brokenquark/repo-ansi/redhat-performance@satellite-performance/playbooks/satellite/roles/client-scripts/tasks/main.yaml,1,0,0,0,0,0,1
2019-03-09 02:14:40.995016, /home/brokenquark/repo-ansi/redhat-performance@satellite-performance/playbooks/monitoring/graphite.yaml,1,0,0,0,0,0,1
2019-03-09 02:14:41.000896, /home/brokenquark/repo-ansi/redhat-performance@satellite-performance/playbooks/monitoring/snapshot_perf_dashboard.yaml,3,0,0,0,0,0,3
2019-03-09 02:14:41.006509, /home/brokenquark/repo-ansi/redhat-performance@satellite-performance/playbooks/monitoring/collectd-generic.yaml,4,0,0,0,0,0,4
2019-03-09 02:14:41.008044, /home/brokenquark/repo-ansi/redhat-performance@satellite-performance/playbooks/monitoring/elk.yaml,1,0,0,0,0,0,1
2019-03-09 02:14:41.009055, /home/brokenquark/repo-ansi/redhat-performance@satellite-performance/playbooks/monitoring/elk-client.yaml,1,0,0,0,0,0,1
2019-03-09 02:14:41.010860, /home/brokenquark/repo-ansi/redhat-performance@satellite-performance/playbooks/monitoring/grafana.yaml,1,0,0,0,0,0,1
2019-03-09 02:14:41.012870, /home/brokenquark/repo-ansi/redhat-performance@satellite-performance/playbooks/monitoring/dashboards-generic.yaml,1,0,0,0,0,0,1
2019-03-09 02:14:41.032969, /home/brokenquark/repo-ansi/redhat-performance@satellite-performance/playbooks/monitoring/roles/graphite/tasks/main.yml,0,0,0,0,1,0,1
2019-03-09 02:14:41.046778, /home/brokenquark/repo-ansi/redhat-performance@satellite-performance/playbooks/monitoring/roles/collectd-generic/tasks/main.yml,0,0,0,0,1,0,1
2019-03-09 02:14:41.056386, /home/brokenquark/repo-ansi/redhat-performance@satellite-performance/playbooks/monitoring/roles/grafana/tasks/main.yml,0,0,0,0,0,1,1
2019-03-09 02:14:41.091462, /home/brokenquark/repo-ansi/redhat-performance@satellite-performance/playbooks/tests/hammer-list.yaml,1,0,0,0,0,0,1
2019-03-09 02:14:41.123724, /home/brokenquark/repo-ansi/redhat-performance@satellite-performance/playbooks/tests/puppet-big-setup.yaml,1,0,0,0,0,0,1
2019-03-09 02:14:41.134053, /home/brokenquark/repo-ansi/redhat-performance@satellite-performance/playbooks/tests/puppet-single-setup.yaml,1,0,0,0,0,0,1
2019-03-09 02:14:41.137373, /home/brokenquark/repo-ansi/redhat-performance@satellite-performance/playbooks/tests/continuous-rex.yaml,1,0,0,0,0,0,1
2019-03-09 02:14:41.154268, /home/brokenquark/repo-ansi/redhat-performance@satellite-performance/playbooks/tests/registrations.yaml,2,0,0,0,0,0,2
2019-03-09 02:14:41.161404, /home/brokenquark/repo-ansi/redhat-performance@satellite-performance/playbooks/tests/generate-applicability.yaml,1,0,0,0,0,0,1
2019-03-09 02:14:41.183180, /home/brokenquark/repo-ansi/redhat-performance@satellite-performance/playbooks/tests/sync-repositories.yaml,1,0,1,0,0,0,2
2019-03-09 02:14:41.199208, /home/brokenquark/repo-ansi/redhat-performance@satellite-performance/playbooks/tests/puppet-setup.yaml,3,0,0,0,0,0,3
2019-03-09 02:14:41.204432, /home/brokenquark/repo-ansi/redhat-performance@satellite-performance/playbooks/tests/containers.yaml,1,0,0,0,0,0,1
2019-03-09 02:14:41.207372, /home/brokenquark/repo-ansi/redhat-performance@satellite-performance/playbooks/tests/candlepin_identity_regenerate.yaml,1,0,0,0,0,0,1
2019-03-09 02:14:41.212744, /home/brokenquark/repo-ansi/redhat-performance@satellite-performance/playbooks/tests/continuous-reg.yaml,1,0,0,0,0,0,1
2019-03-09 02:14:41.222626, /home/brokenquark/repo-ansi/redhat-performance@satellite-performance/playbooks/tests/puppet-big-test.yaml,1,0,0,0,0,0,1
2019-03-09 02:14:41.238121, /home/brokenquark/repo-ansi/redhat-performance@satellite-performance/playbooks/tests/rex.yaml,1,0,0,0,0,0,1
2019-03-09 02:14:41.251781, /home/brokenquark/repo-ansi/redhat-performance@satellite-performance/playbooks/tests/puppet.yaml,1,0,0,0,0,0,1
2019-03-09 02:14:41.274394, /home/brokenquark/repo-ansi/redhat-performance@satellite-performance/playbooks/katello/installation.yaml,1,0,0,0,0,0,1
2019-03-09 02:14:41.285301, /home/brokenquark/repo-ansi/redhat-performance@satellite-performance/playbooks/katello/roles/add_katello_repos/tasks/main.yaml,0,0,4,0,0,0,4
2019-03-09 02:14:41.296181, /home/brokenquark/repo-ansi/redhat-performance@satellite-performance/playbooks/soak-tests/content-view-promote.yaml,1,0,0,0,0,0,1
2019-03-09 02:14:41.297419, /home/brokenquark/repo-ansi/redhat-performance@satellite-performance/playbooks/soak-tests/daily-cv-ops.yaml,1,0,0,0,0,0,1
2019-03-09 02:14:41.298531, /home/brokenquark/repo-ansi/redhat-performance@satellite-performance/playbooks/soak-tests/content-view-publish.yaml,1,0,0,0,0,0,1
2019-03-09 02:14:41.300537, /home/brokenquark/repo-ansi/redhat-performance@satellite-performance/playbooks/soak-tests/test-config.yaml,1,0,0,0,0,0,1
2019-03-09 02:14:41.301767, /home/brokenquark/repo-ansi/redhat-performance@satellite-performance/playbooks/soak-tests/errata-apply.yaml,1,0,0,0,0,0,1
2019-03-09 02:14:41.302877, /home/brokenquark/repo-ansi/redhat-performance@satellite-performance/playbooks/soak-tests/sync-plan.yaml,1,0,0,0,0,0,1
2019-03-09 02:14:41.304632, /home/brokenquark/repo-ansi/redhat-performance@satellite-performance/playbooks/soak-tests/content-setup.yaml,1,0,0,0,0,0,1
2019-03-09 02:14:41.305841, /home/brokenquark/repo-ansi/redhat-performance@satellite-performance/playbooks/soak-tests/rex-job.yaml,1,0,0,0,0,0,1
2019-03-09 02:14:41.361611, /home/brokenquark/repo-ansi/redhat-performance@satellite-performance/playbooks/containerized/install.yaml,1,0,0,0,0,0,1
2019-03-09 02:14:41.362221, /home/brokenquark/repo-ansi/redhat-performance@satellite-performance/playbooks/containerized/roles/install-openshift-oc/vars/main.yaml,0,0,0,0,0,1,1
2019-03-09 02:14:41.364652, /home/brokenquark/repo-ansi/redhat-performance@satellite-performance/playbooks/containerized/roles/install-openshift-oc/tasks/main.yaml,1,0,0,0,0,0,1
2019-03-09 02:14:41.382565, /home/brokenquark/repo-ansi/redhat-performance@satellite-performance/playbooks/containerized/roles/install-openshift-cluster-up/tasks/main.yaml,0,0,0,0,1,0,1
2019-03-09 02:14:41.400078, /home/brokenquark/repo-ansi/redhat-performance@satellite-performance/playbooks/external_dbs/setup.yaml,6,0,0,0,0,0,6
2019-03-09 02:14:41.401632, /home/brokenquark/repo-ansi/redhat-performance@satellite-performance/playbooks/experiments/satellite_remote_db.yaml,1,0,0,0,0,0,1
2019-03-09 02:14:41.415758, /home/brokenquark/repo-ansi/redhat-performance@satellite-performance/playbooks/experiments/roles/pg_remote_db_populate/tasks/main.yaml,7,0,0,0,0,0,7
2019-03-09 02:14:41.436213, /home/brokenquark/repo-ansi/redhat-performance@satellite-performance/playbooks/experiments/roles/pg_satellite_dump/tasks/main.yaml,3,0,0,0,0,0,3
2019-03-09 02:14:41.455001, /home/brokenquark/repo-ansi/redhat-performance@satellite-performance/playbooks/kvm-hosts/cleanup.yaml,1,0,0,0,0,0,1
2019-03-09 02:14:41.465373, /home/brokenquark/repo-ansi/redhat-performance@satellite-performance/playbooks/kvm-hosts/install-vms.yaml,1,0,0,0,0,0,1
2019-03-09 02:14:41.468717, /home/brokenquark/repo-ansi/redhat-performance@satellite-performance/playbooks/kvm-hosts/check.yaml,1,0,0,0,0,0,1
2019-03-09 02:14:41.470535, /home/brokenquark/repo-ansi/redhat-performance@satellite-performance/playbooks/kvm-hosts/host.yaml,1,0,0,0,0,0,1
2019-03-09 02:14:41.569353, /home/brokenquark/repo-ansi/rhevm-qe-automation@ovirt-ansible/examples/playbooks/iso_uploader_conf.yaml,1,0,0,0,0,0,1
2019-03-09 02:14:41.570287, /home/brokenquark/repo-ansi/rhevm-qe-automation@ovirt-ansible/examples/playbooks/backup_engine.yml,1,0,0,0,0,0,1
2019-03-09 02:14:41.571195, /home/brokenquark/repo-ansi/rhevm-qe-automation@ovirt-ansible/examples/playbooks/cleanup_engine.yml,1,0,0,0,0,0,1
2019-03-09 02:14:41.574715, /home/brokenquark/repo-ansi/rhevm-qe-automation@ovirt-ansible/examples/playbooks/remote_db.yml,4,0,0,1,0,0,5
2019-03-09 02:14:51.632339, /home/brokenquark/repo-ansi/rocknsm@SimpleRock/playbooks/setup-deploy-host.yml,6,0,0,0,0,1,7
2019-03-09 02:14:51.649114, /home/brokenquark/repo-ansi/rocknsm@SimpleRock/playbooks/generate-defaults.yml,2,0,0,0,0,0,2
2019-03-09 02:14:51.672990, /home/brokenquark/repo-ansi/rocknsm@SimpleRock/playbooks/group_vars/all.yml,9,0,1,1,0,0,11
2019-03-09 02:14:52.435402, /home/brokenquark/repo-ansi/rocknsm@rock/playbooks/setup-deploy-host.yml,6,0,0,0,0,1,7
2019-03-09 02:14:52.452577, /home/brokenquark/repo-ansi/rocknsm@rock/playbooks/generate-defaults.yml,2,0,0,0,0,0,2
2019-03-09 02:14:52.476846, /home/brokenquark/repo-ansi/rocknsm@rock/playbooks/group_vars/all.yml,9,0,1,1,0,0,11
2019-03-09 02:15:07.341718, /home/brokenquark/repo-ansi/sborenst@ansible_agnostic_deployer/tools/archive/configs/RHCLS-ScalableInfra-demo/playbooks/bastion-play.yml,1,0,0,0,0,0,1
2019-03-09 02:15:07.343577, /home/brokenquark/repo-ansi/sborenst@ansible_agnostic_deployer/tools/archive/configs/RHCLS-ScalableInfra-demo/playbooks/variables.yml,1,0,1,0,0,0,2
2019-03-09 02:15:07.352522, /home/brokenquark/repo-ansi/sborenst@ansible_agnostic_deployer/tools/archive/configs/RHCLS-ScalableInfra-demo/playbooks/roles/bastion/tests/test.yml,1,0,0,0,0,0,1
2019-03-09 02:15:07.355680, /home/brokenquark/repo-ansi/sborenst@ansible_agnostic_deployer/tools/archive/configs/RHCLS-ScalableInfra-demo/playbooks/roles/bastion/tests/bastion-play.yml,1,0,0,0,0,0,1
2019-03-09 02:15:07.397084, /home/brokenquark/repo-ansi/sborenst@ansible_agnostic_deployer/tools/archive/configs/RHCLS-ScalableInfra-demo/playbooks/roles/osp/tests/test.yml,1,0,0,0,0,0,1
2019-03-09 02:15:07.431773, /home/brokenquark/repo-ansi/sborenst@ansible_agnostic_deployer/tools/archive/configs/RHCLS-ScalableInfra-demo/playbooks/roles/packages/tests/test.yml,1,0,0,0,0,0,1
2019-03-09 02:15:07.443291, /home/brokenquark/repo-ansi/sborenst@ansible_agnostic_deployer/tools/archive/configs/RHCLS-ScalableInfra-demo/playbooks/roles/packages/tasks/osp.yml,0,0,0,0,0,1,1
2019-03-09 02:15:07.449685, /home/brokenquark/repo-ansi/sborenst@ansible_agnostic_deployer/tools/archive/configs/RHCLS-ScalableInfra-demo/playbooks/roles/packages/tasks/bastion.yml,0,0,0,0,0,1,1
2019-03-09 02:15:12.432363, /home/brokenquark/repo-ansi/snowplow@ansible-playbooks//thrift.yml,1,0,0,0,0,0,1
2019-03-09 02:15:12.433848, /home/brokenquark/repo-ansi/snowplow@ansible-playbooks//python-virtualenv.yml,1,0,0,0,0,0,1
2019-03-09 02:15:12.435701, /home/brokenquark/repo-ansi/snowplow@ansible-playbooks//consul-0.7.5.yml,1,0,0,0,0,0,1
2019-03-09 02:15:12.437175, /home/brokenquark/repo-ansi/snowplow@ansible-playbooks//snowplow-realtime-pipeline.yml,1,0,0,0,0,0,1
2019-03-09 02:15:12.438496, /home/brokenquark/repo-ansi/snowplow@ansible-playbooks//pygerduty.yml,1,0,0,0,0,0,1
2019-03-09 02:15:12.439812, /home/brokenquark/repo-ansi/snowplow@ansible-playbooks//python-pyenv.yml,1,0,0,0,0,0,1
2019-03-09 02:15:12.441090, /home/brokenquark/repo-ansi/snowplow@ansible-playbooks//gatling.yml,1,0,0,0,0,0,1
2019-03-09 02:15:12.442325, /home/brokenquark/repo-ansi/snowplow@ansible-playbooks//elasticsearch.yml,1,0,0,0,0,0,1
2019-03-09 02:15:12.443574, /home/brokenquark/repo-ansi/snowplow@ansible-playbooks//packer.yml,1,0,0,0,0,0,1
2019-03-09 02:15:12.444865, /home/brokenquark/repo-ansi/snowplow@ansible-playbooks//postgres.yml,1,0,0,0,0,0,1
2019-03-09 02:15:12.446389, /home/brokenquark/repo-ansi/snowplow@ansible-playbooks//golang-1.10.2.yml,1,0,0,0,0,0,1
2019-03-09 02:15:12.448003, /home/brokenquark/repo-ansi/snowplow@ansible-playbooks//java8.yml,1,0,0,0,0,0,1
2019-03-09 02:15:12.449252, /home/brokenquark/repo-ansi/snowplow@ansible-playbooks//jq.yml,1,0,0,0,0,0,1
2019-03-09 02:15:12.450516, /home/brokenquark/repo-ansi/snowplow@ansible-playbooks//oh-my-zsh.yml,1,0,0,0,0,0,1
2019-03-09 02:15:12.452005, /home/brokenquark/repo-ansi/snowplow@ansible-playbooks//consul-0.8.3.yml,1,0,0,0,0,0,1
2019-03-09 02:15:12.453475, /home/brokenquark/repo-ansi/snowplow@ansible-playbooks//snowplow-javascript-tracker.yml,1,0,0,0,0,0,1
2019-03-09 02:15:12.457101, /home/brokenquark/repo-ansi/snowplow@ansible-playbooks//snowplow-website.yml,3,0,0,0,0,0,3
2019-03-09 02:15:12.458904, /home/brokenquark/repo-ansi/snowplow@ansible-playbooks//rust.yml,1,0,0,0,0,0,1
2019-03-09 02:15:12.461209, /home/brokenquark/repo-ansi/snowplow@ansible-playbooks//java10.yml,1,0,0,0,0,0,1
2019-03-09 02:15:12.462995, /home/brokenquark/repo-ansi/snowplow@ansible-playbooks//boto.yml,1,0,0,0,0,0,1
2019-03-09 02:15:12.464769, /home/brokenquark/repo-ansi/snowplow@ansible-playbooks//docker.yml,1,0,0,0,0,0,1
2019-03-09 02:15:12.466718, /home/brokenquark/repo-ansi/snowplow@ansible-playbooks//gradle2.yml,1,0,0,0,0,0,1
2019-03-09 02:15:12.471038, /home/brokenquark/repo-ansi/snowplow@ansible-playbooks//ruby-rvm-new.yml,2,0,0,0,0,0,2
2019-03-09 02:15:12.472761, /home/brokenquark/repo-ansi/snowplow@ansible-playbooks//r-studio-server.yml,1,0,0,0,0,0,1
2019-03-09 02:15:12.474908, /home/brokenquark/repo-ansi/snowplow@ansible-playbooks//consul.yml,1,0,0,0,0,0,1
2019-03-09 02:15:12.477093, /home/brokenquark/repo-ansi/snowplow@ansible-playbooks//thrift-0.10.0.yml,1,0,0,0,0,0,1
2019-03-09 02:15:12.478807, /home/brokenquark/repo-ansi/snowplow@ansible-playbooks//python-sphinx.yml,1,0,0,0,0,0,1
2019-03-09 02:15:12.480557, /home/brokenquark/repo-ansi/snowplow@ansible-playbooks//grunt.yml,1,0,0,0,0,0,1
2019-03-09 02:15:12.482713, /home/brokenquark/repo-ansi/snowplow@ansible-playbooks//golang-1.8.yml,1,0,0,0,0,0,1
2019-03-09 02:15:12.484440, /home/brokenquark/repo-ansi/snowplow@ansible-playbooks//ruby-rvm.yml,1,0,0,0,0,0,1
2019-03-09 02:15:12.485698, /home/brokenquark/repo-ansi/snowplow@ansible-playbooks//python-filechunkio.yml,1,0,0,0,0,0,1
2019-03-09 02:15:12.487721, /home/brokenquark/repo-ansi/snowplow@ansible-playbooks//gradle.yml,1,0,0,0,0,0,1
2019-03-09 02:15:12.490125, /home/brokenquark/repo-ansi/snowplow@ansible-playbooks//postgres-client.yml,1,0,0,0,0,0,1
2019-03-09 02:15:12.492309, /home/brokenquark/repo-ansi/snowplow@ansible-playbooks//golang.yml,1,0,0,0,0,0,1
2019-03-09 02:15:12.494070, /home/brokenquark/repo-ansi/snowplow@ansible-playbooks//boto3.yml,1,0,0,0,0,0,1
2019-03-09 02:15:12.496343, /home/brokenquark/repo-ansi/snowplow@ansible-playbooks//scala.yml,1,0,0,0,0,0,1
2019-03-09 02:15:12.499508, /home/brokenquark/repo-ansi/snowplow@ansible-playbooks//snowplow-batch-pipeline.yml,1,0,0,0,0,0,1
2019-03-09 02:15:12.501574, /home/brokenquark/repo-ansi/snowplow@ansible-playbooks//leiningen.yml,1,0,0,0,0,0,1
2019-03-09 02:15:12.503242, /home/brokenquark/repo-ansi/snowplow@ansible-playbooks//scala-2.10.5.yml,1,0,0,0,0,0,1
2019-03-09 02:15:12.505023, /home/brokenquark/repo-ansi/snowplow@ansible-playbooks//snowplow-python-tracker.yml,1,0,0,0,0,0,1
2019-03-09 02:15:12.507261, /home/brokenquark/repo-ansi/snowplow@ansible-playbooks//sbt.yml,1,0,0,0,0,0,1
2019-03-09 02:15:12.512640, /home/brokenquark/repo-ansi/snowplow@ansible-playbooks//snowplow-website-new.yml,3,0,0,0,0,0,3
2019-03-09 02:15:12.514352, /home/brokenquark/repo-ansi/snowplow@ansible-playbooks//aws-cli-and-psql.yml,1,0,0,0,0,0,1
2019-03-09 02:15:12.515606, /home/brokenquark/repo-ansi/snowplow@ansible-playbooks//typescript.yml,1,0,0,0,0,0,1
2019-03-09 02:15:12.516945, /home/brokenquark/repo-ansi/snowplow@ansible-playbooks//aws-tools.yml,1,0,0,0,0,0,1
2019-03-09 02:15:12.518422, /home/brokenquark/repo-ansi/snowplow@ansible-playbooks//sbt-13.8.yml,1,0,0,0,0,0,1
2019-03-09 02:15:12.519676, /home/brokenquark/repo-ansi/snowplow@ansible-playbooks//invoke.yml,1,0,0,0,0,0,1
2019-03-09 02:15:12.520902, /home/brokenquark/repo-ansi/snowplow@ansible-playbooks//gulp.yml,1,0,0,0,0,0,1
2019-03-09 02:15:12.522533, /home/brokenquark/repo-ansi/snowplow@ansible-playbooks//spark.yml,1,0,0,0,0,0,1
2019-03-09 02:15:12.524024, /home/brokenquark/repo-ansi/snowplow@ansible-playbooks//scala-2.11.6.yml,1,0,0,0,0,0,1
2019-03-09 02:15:12.533696, /home/brokenquark/repo-ansi/snowplow@ansible-playbooks//neo4j-demo.yml,1,0,0,0,0,0,1
2019-03-09 02:15:12.535023, /home/brokenquark/repo-ansi/snowplow@ansible-playbooks//mountebank.yml,1,0,0,0,0,0,1
2019-03-09 02:15:12.536289, /home/brokenquark/repo-ansi/snowplow@ansible-playbooks//neo4j.yml,1,0,0,0,0,0,1
2019-03-09 02:15:12.537517, /home/brokenquark/repo-ansi/snowplow@ansible-playbooks//android.yml,1,0,0,0,0,0,1
2019-03-09 02:15:12.538776, /home/brokenquark/repo-ansi/snowplow@ansible-playbooks//elasticsearch-reindex.yml,1,0,0,0,0,0,1
2019-03-09 02:15:12.540276, /home/brokenquark/repo-ansi/snowplow@ansible-playbooks//golang-1.8.3.yml,1,0,0,0,0,0,1
2019-03-09 02:15:12.541507, /home/brokenquark/repo-ansi/snowplow@ansible-playbooks//python-data-science.yml,1,0,0,0,0,0,1
2019-03-09 02:15:12.542728, /home/brokenquark/repo-ansi/snowplow@ansible-playbooks//lzo.yml,1,0,0,0,0,0,1
2019-03-09 02:15:12.543941, /home/brokenquark/repo-ansi/snowplow@ansible-playbooks//wine.yml,1,0,0,0,0,0,1
2019-03-09 02:15:12.545163, /home/brokenquark/repo-ansi/snowplow@ansible-playbooks//nodejs.yml,1,0,0,0,0,0,1
2019-03-09 02:15:12.546653, /home/brokenquark/repo-ansi/snowplow@ansible-playbooks//golang-1.9.2.yml,1,0,0,0,0,0,1
2019-03-09 02:15:12.547913, /home/brokenquark/repo-ansi/snowplow@ansible-playbooks//gcloud.yml,1,0,0,0,0,0,1
2019-03-09 02:15:12.549148, /home/brokenquark/repo-ansi/snowplow@ansible-playbooks//ngrok.yml,1,0,0,0,0,0,1
2019-03-09 02:15:12.565920, /home/brokenquark/repo-ansi/snowplow@ansible-playbooks/roles/golang/vars/main.yml,0,0,1,0,0,0,1
2019-03-09 02:15:12.652669, /home/brokenquark/repo-ansi/snowplow@ansible-playbooks/roles/rvm_io.rvm1-ruby/tests/test.yml,1,0,0,0,0,0,1
2019-03-09 02:15:12.658472, /home/brokenquark/repo-ansi/snowplow@ansible-playbooks/roles/rvm_io.rvm1-ruby/defaults/main.yml,1,0,0,0,0,0,1
2019-03-09 02:15:12.688656, /home/brokenquark/repo-ansi/snowplow@ansible-playbooks/roles/rvm_io.rvm1-ruby/tasks/rubies.yml,1,0,0,0,0,0,1
2019-03-09 02:15:12.725382, /home/brokenquark/repo-ansi/snowplow@ansible-playbooks/roles/rust/vars/main.yml,0,0,0,0,0,1,1
2019-03-09 02:15:12.750176, /home/brokenquark/repo-ansi/snowplow@ansible-playbooks/roles/rstudio-server/tasks/main.yml,1,0,0,0,0,0,1
2019-03-09 02:15:12.786074, /home/brokenquark/repo-ansi/snowplow@ansible-playbooks/roles/neo4j/tasks/add-apt-repo-for-neo4j.yml,1,0,0,0,0,0,1
2019-03-09 02:15:12.811399, /home/brokenquark/repo-ansi/snowplow@ansible-playbooks/roles/oh-my-zsh/tasks/main.yml,1,0,0,0,0,0,1
2019-03-09 02:15:12.819981, /home/brokenquark/repo-ansi/snowplow@ansible-playbooks/roles/scala/vars/main.yml,0,0,1,0,0,0,1
2019-03-09 02:15:12.847200, /home/brokenquark/repo-ansi/snowplow@ansible-playbooks/roles/thrift/vars/main.yml,0,0,1,0,0,0,1
2019-03-09 02:15:12.913249, /home/brokenquark/repo-ansi/snowplow@ansible-playbooks/roles/postgres/tasks/add-apt-repo-for-postgres.yml,1,0,0,0,0,0,1
2019-03-09 02:15:12.921140, /home/brokenquark/repo-ansi/snowplow@ansible-playbooks/roles/r/tasks/add-apt-repo-for-r.yml,1,0,0,0,0,0,1
2019-03-09 02:15:18.837521, /home/brokenquark/repo-ansi/stackforge@os-ansible-deployment/playbooks/etcd-install.yml,1,0,0,0,0,0,1
2019-03-09 02:15:18.848552, /home/brokenquark/repo-ansi/stackforge@os-ansible-deployment/playbooks/os-trove-install.yml,1,0,0,0,0,0,1
2019-03-09 02:15:18.854590, /home/brokenquark/repo-ansi/stackforge@os-ansible-deployment/playbooks/os-tacker-install.yml,1,0,0,0,0,0,1
2019-03-09 02:15:18.861346, /home/brokenquark/repo-ansi/stackforge@os-ansible-deployment/playbooks/memcached-install.yml,1,0,0,0,0,0,1
2019-03-09 02:15:18.887743, /home/brokenquark/repo-ansi/stackforge@os-ansible-deployment/playbooks/ceph-rgw-install.yml,1,0,0,0,0,0,1
2019-03-09 02:15:18.906028, /home/brokenquark/repo-ansi/stackforge@os-ansible-deployment/playbooks/ceph-rgw-keystone-setup.yml,1,0,0,0,0,0,1
2019-03-09 02:15:18.914591, /home/brokenquark/repo-ansi/stackforge@os-ansible-deployment/playbooks/openstack-hosts-setup.yml,2,0,0,0,0,0,2
2019-03-09 02:15:19.003165, /home/brokenquark/repo-ansi/stackforge@os-ansible-deployment/playbooks/os-gnocchi-install.yml,1,0,0,0,0,0,1
2019-03-09 02:15:19.016741, /home/brokenquark/repo-ansi/stackforge@os-ansible-deployment/playbooks/rabbitmq-install.yml,4,0,0,0,0,0,4
2019-03-09 02:15:19.041995, /home/brokenquark/repo-ansi/stackforge@os-ansible-deployment/playbooks/os-keystone-install.yml,2,0,0,0,0,0,2
2019-03-09 02:15:19.062408, /home/brokenquark/repo-ansi/stackforge@os-ansible-deployment/playbooks/os-glance-install.yml,2,0,0,0,0,0,2
2019-03-09 02:15:19.097755, /home/brokenquark/repo-ansi/stackforge@os-ansible-deployment/playbooks/healthcheck-infrastructure.yml,4,0,0,0,0,0,4
2019-03-09 02:15:19.104432, /home/brokenquark/repo-ansi/stackforge@os-ansible-deployment/playbooks/os-barbican-install.yml,1,0,0,0,0,0,1
2019-03-09 02:15:19.130920, /home/brokenquark/repo-ansi/stackforge@os-ansible-deployment/playbooks/os-nova-install.yml,4,0,0,0,0,0,4
2019-03-09 02:15:19.134519, /home/brokenquark/repo-ansi/stackforge@os-ansible-deployment/playbooks/os-swift-sync.yml,1,0,0,0,0,0,1
2019-03-09 02:15:19.137561, /home/brokenquark/repo-ansi/stackforge@os-ansible-deployment/playbooks/containers-nspawn-host.yml,1,0,0,0,0,0,1
2019-03-09 02:15:19.146637, /home/brokenquark/repo-ansi/stackforge@os-ansible-deployment/playbooks/os-octavia-install.yml,1,0,0,0,0,0,1
2019-03-09 02:15:19.152913, /home/brokenquark/repo-ansi/stackforge@os-ansible-deployment/playbooks/unbound-install.yml,2,0,0,0,0,0,2
2019-03-09 02:15:19.161054, /home/brokenquark/repo-ansi/stackforge@os-ansible-deployment/playbooks/os-congress-install.yml,1,0,0,0,0,0,1
2019-03-09 02:15:19.167838, /home/brokenquark/repo-ansi/stackforge@os-ansible-deployment/playbooks/os-designate-install.yml,1,0,0,0,0,0,1
2019-03-09 02:15:19.185274, /home/brokenquark/repo-ansi/stackforge@os-ansible-deployment/playbooks/infra-journal-remote.yml,7,0,0,0,0,0,7
2019-03-09 02:15:19.191214, /home/brokenquark/repo-ansi/stackforge@os-ansible-deployment/playbooks/os-tempest-install.yml,1,0,0,0,0,0,1
2019-03-09 02:15:19.202398, /home/brokenquark/repo-ansi/stackforge@os-ansible-deployment/playbooks/os-swift-install.yml,2,0,0,0,0,0,2
2019-03-09 02:15:19.217098, /home/brokenquark/repo-ansi/stackforge@os-ansible-deployment/playbooks/repo-build.yml,1,0,0,0,0,0,1
2019-03-09 02:15:19.231253, /home/brokenquark/repo-ansi/stackforge@os-ansible-deployment/playbooks/os-horizon-install.yml,1,0,0,0,0,0,1
2019-03-09 02:15:19.237871, /home/brokenquark/repo-ansi/stackforge@os-ansible-deployment/playbooks/os-ceilometer-install.yml,1,0,0,0,0,0,1
2019-03-09 02:15:19.246260, /home/brokenquark/repo-ansi/stackforge@os-ansible-deployment/playbooks/os-blazar-install.yml,1,0,0,0,0,0,1
2019-03-09 02:15:19.268264, /home/brokenquark/repo-ansi/stackforge@os-ansible-deployment/playbooks/containers-nspawn-create.yml,3,0,0,0,0,0,3
2019-03-09 02:15:19.279716, /home/brokenquark/repo-ansi/stackforge@os-ansible-deployment/playbooks/galera-install.yml,2,0,0,0,0,0,2
2019-03-09 02:15:19.291213, /home/brokenquark/repo-ansi/stackforge@os-ansible-deployment/playbooks/containers-lxc-create.yml,3,0,0,0,0,0,3
2019-03-09 02:15:19.295016, /home/brokenquark/repo-ansi/stackforge@os-ansible-deployment/playbooks/os-rally-install.yml,1,0,0,0,0,0,1
2019-03-09 02:15:19.298208, /home/brokenquark/repo-ansi/stackforge@os-ansible-deployment/playbooks/security-hardening.yml,1,0,0,0,0,0,1
2019-03-09 02:15:19.322910, /home/brokenquark/repo-ansi/stackforge@os-ansible-deployment/playbooks/ceph-install.yml,3,0,0,0,0,0,3
2019-03-09 02:15:19.350507, /home/brokenquark/repo-ansi/stackforge@os-ansible-deployment/playbooks/os-cinder-install.yml,4,0,0,0,0,0,4
2019-03-09 02:15:19.369318, /home/brokenquark/repo-ansi/stackforge@os-ansible-deployment/playbooks/utility-install.yml,3,0,0,0,0,0,3
2019-03-09 02:15:19.381392, /home/brokenquark/repo-ansi/stackforge@os-ansible-deployment/playbooks/containers-lxc-host.yml,1,0,0,0,0,0,1
2019-03-09 02:15:19.388197, /home/brokenquark/repo-ansi/stackforge@os-ansible-deployment/playbooks/rsyslog-install.yml,1,0,0,0,0,0,1
2019-03-09 02:15:19.395647, /home/brokenquark/repo-ansi/stackforge@os-ansible-deployment/playbooks/os-magnum-install.yml,1,0,0,0,0,0,1
2019-03-09 02:15:19.412815, /home/brokenquark/repo-ansi/stackforge@os-ansible-deployment/playbooks/containers-nspawn-destroy.yml,2,0,0,0,0,0,2
2019-03-09 02:15:19.426337, /home/brokenquark/repo-ansi/stackforge@os-ansible-deployment/playbooks/os-heat-install.yml,1,0,0,0,0,0,1
2019-03-09 02:15:19.440106, /home/brokenquark/repo-ansi/stackforge@os-ansible-deployment/playbooks/lxc-containers-destroy.yml,2,0,0,0,0,0,2
2019-03-09 02:15:19.446687, /home/brokenquark/repo-ansi/stackforge@os-ansible-deployment/playbooks/os-aodh-install.yml,1,0,0,0,0,0,1
2019-03-09 02:15:19.457685, /home/brokenquark/repo-ansi/stackforge@os-ansible-deployment/playbooks/haproxy-install.yml,1,0,0,0,0,0,1
2019-03-09 02:15:19.469096, /home/brokenquark/repo-ansi/stackforge@os-ansible-deployment/playbooks/lxc-containers-create.yml,3,0,0,0,0,0,3
2019-03-09 02:15:19.482853, /home/brokenquark/repo-ansi/stackforge@os-ansible-deployment/playbooks/containers-lxc-destroy.yml,2,0,0,0,0,0,2
2019-03-09 02:15:19.488997, /home/brokenquark/repo-ansi/stackforge@os-ansible-deployment/playbooks/os-ironic-install.yml,1,0,0,0,0,0,1
2019-03-09 02:15:19.498742, /home/brokenquark/repo-ansi/stackforge@os-ansible-deployment/playbooks/lxc-hosts-setup.yml,1,0,0,0,0,0,1
2019-03-09 02:15:19.511364, /home/brokenquark/repo-ansi/stackforge@os-ansible-deployment/playbooks/repo-server.yml,1,0,0,0,0,0,1
2019-03-09 02:15:19.517989, /home/brokenquark/repo-ansi/stackforge@os-ansible-deployment/playbooks/os-sahara-install.yml,1,0,0,0,0,0,1
2019-03-09 02:15:19.536685, /home/brokenquark/repo-ansi/stackforge@os-ansible-deployment/playbooks/common-playbooks/neutron.yml,1,0,0,0,0,0,1
2019-03-09 02:15:19.563998, /home/brokenquark/repo-ansi/stackforge@os-ansible-deployment/playbooks/common-playbooks/nova.yml,1,0,0,0,0,0,1
2019-03-09 02:15:19.580620, /home/brokenquark/repo-ansi/stackforge@os-ansible-deployment/playbooks/common-playbooks/cinder.yml,1,0,0,0,0,0,1
2019-03-09 02:15:19.593033, /home/brokenquark/repo-ansi/stackforge@os-ansible-deployment/playbooks/common-playbooks/glance.yml,1,0,0,0,0,0,1
2019-03-09 02:15:19.618459, /home/brokenquark/repo-ansi/stackforge@os-ansible-deployment/playbooks/defaults/healthchecks-vars.yml,2,0,2,3,0,0,7
2019-03-09 02:15:19.707714, /home/brokenquark/repo-ansi/stackforge@os-ansible-deployment/playbooks/common-tasks/ceph-server.yml,0,0,1,0,1,0,2
2019-03-09 02:15:19.733296, /home/brokenquark/repo-ansi/stackforge@os-ansible-deployment/playbooks/common-tasks/os-lxc-container-setup.yml,0,0,0,0,4,0,4
2019-03-09 02:15:19.739169, /home/brokenquark/repo-ansi/stackforge@os-ansible-deployment/playbooks/common-tasks/unbound-clients.yml,0,0,0,0,1,0,1
2019-03-09 02:15:19.749590, /home/brokenquark/repo-ansi/stackforge@os-ansible-deployment/playbooks/common-tasks/restart-service.yml,0,0,0,0,1,0,1
2019-03-09 02:15:19.779269, /home/brokenquark/repo-ansi/stackforge@os-ansible-deployment/playbooks/roles/system_crontab_coordination/tasks/main.yml,1,0,0,0,0,0,1
2019-03-09 02:15:19.867558, /home/brokenquark/repo-ansi/stackforge@os-ansible-deployment/zuul.d/playbooks/post.yml,2,0,0,0,0,1,3
2019-03-09 02:15:19.870406, /home/brokenquark/repo-ansi/stackforge@os-ansible-deployment/zuul.d/playbooks/run.yml,1,0,0,0,0,0,1
2019-03-09 02:15:32.367834, /home/brokenquark/repo-ansi/sudheerchintala@LearnEra-Configuration/playbooks/roles/jenkins_master/defaults/main.yml,1,0,1,0,0,0,2
2019-03-09 02:15:32.381351, /home/brokenquark/repo-ansi/sudheerchintala@LearnEra-Configuration/playbooks/roles/jenkins_master/tasks/main.yml,0,0,0,0,4,0,4
2019-03-09 02:15:32.393704, /home/brokenquark/repo-ansi/sudheerchintala@LearnEra-Configuration/playbooks/roles/common/defaults/main.yml,11,1,1,0,0,0,13
2019-03-09 02:15:32.418123, /home/brokenquark/repo-ansi/sudheerchintala@LearnEra-Configuration/playbooks/roles/common/tasks/main.yml,0,0,0,0,1,0,1
2019-03-09 02:15:32.438286, /home/brokenquark/repo-ansi/sudheerchintala@LearnEra-Configuration/playbooks/roles/gerrit/defaults/main.yml,1,0,0,0,0,0,1
2019-03-09 02:15:32.461896, /home/brokenquark/repo-ansi/sudheerchintala@LearnEra-Configuration/playbooks/roles/xserver/defaults/main.yml,3,0,0,0,0,0,3
2019-03-09 02:15:32.483655, /home/brokenquark/repo-ansi/sudheerchintala@LearnEra-Configuration/playbooks/roles/test_build_server/defaults/main.yml,1,0,0,0,0,0,1
2019-03-09 02:15:32.491011, /home/brokenquark/repo-ansi/sudheerchintala@LearnEra-Configuration/playbooks/roles/aws/defaults/main.yml,0,0,1,0,1,1,3
2019-03-09 02:15:32.500232, /home/brokenquark/repo-ansi/sudheerchintala@LearnEra-Configuration/playbooks/roles/aws/tasks/main.yml,1,0,0,0,0,0,1
2019-03-09 02:15:32.509937, /home/brokenquark/repo-ansi/sudheerchintala@LearnEra-Configuration/playbooks/roles/forum/defaults/main.yml,3,0,0,1,0,0,4
2019-03-09 02:15:32.541032, /home/brokenquark/repo-ansi/sudheerchintala@LearnEra-Configuration/playbooks/roles/analytics-api/defaults/main.yml,7,1,0,0,0,0,8
2019-03-09 02:15:32.575452, /home/brokenquark/repo-ansi/sudheerchintala@LearnEra-Configuration/playbooks/roles/ora/defaults/main.yml,13,0,0,0,0,0,13
2019-03-09 02:15:32.603726, /home/brokenquark/repo-ansi/sudheerchintala@LearnEra-Configuration/playbooks/roles/redis/defaults/main.yml,1,1,0,0,0,0,2
2019-03-09 02:15:32.610722, /home/brokenquark/repo-ansi/sudheerchintala@LearnEra-Configuration/playbooks/roles/elasticsearch/defaults/main.yml,1,0,0,0,0,0,1
2019-03-09 02:15:32.625879, /home/brokenquark/repo-ansi/sudheerchintala@LearnEra-Configuration/playbooks/roles/antivirus/defaults/main.yml,1,0,0,0,0,0,1
2019-03-09 02:15:32.646003, /home/brokenquark/repo-ansi/sudheerchintala@LearnEra-Configuration/playbooks/roles/flower/defaults/main.yml,3,0,0,1,0,0,4
2019-03-09 02:15:32.656294, /home/brokenquark/repo-ansi/sudheerchintala@LearnEra-Configuration/playbooks/roles/gh_mirror/defaults/main.yml,1,0,0,0,0,0,1
2019-03-09 02:15:32.669261, /home/brokenquark/repo-ansi/sudheerchintala@LearnEra-Configuration/playbooks/roles/analytics/defaults/main.yml,8,0,0,0,0,0,8
2019-03-09 02:15:32.689181, /home/brokenquark/repo-ansi/sudheerchintala@LearnEra-Configuration/playbooks/roles/devpi/defaults/main.yml,2,0,0,0,0,0,2
2019-03-09 02:15:32.716996, /home/brokenquark/repo-ansi/sudheerchintala@LearnEra-Configuration/playbooks/roles/user/defaults/main.yml,0,0,0,0,1,0,1
2019-03-09 02:15:32.736329, /home/brokenquark/repo-ansi/sudheerchintala@LearnEra-Configuration/playbooks/roles/newrelic/tasks/newrelic-logwatcher.yml,1,0,0,0,0,0,1
2019-03-09 02:15:32.747792, /home/brokenquark/repo-ansi/sudheerchintala@LearnEra-Configuration/playbooks/roles/alton/defaults/main.yml,4,0,0,0,0,0,4
2019-03-09 02:15:32.779801, /home/brokenquark/repo-ansi/sudheerchintala@LearnEra-Configuration/playbooks/roles/gluster/tasks/main.yml,0,0,0,0,1,0,1
2019-03-09 02:15:32.788015, /home/brokenquark/repo-ansi/sudheerchintala@LearnEra-Configuration/playbooks/roles/certs/defaults/main.yml,10,0,0,0,0,0,10
2019-03-09 02:15:32.811930, /home/brokenquark/repo-ansi/sudheerchintala@LearnEra-Configuration/playbooks/roles/demo/defaults/main.yml,6,0,0,0,0,0,6
2019-03-09 02:15:32.822559, /home/brokenquark/repo-ansi/sudheerchintala@LearnEra-Configuration/playbooks/roles/oraclejdk/defaults/main.yml,0,0,1,0,0,0,1
2019-03-09 02:15:32.831986, /home/brokenquark/repo-ansi/sudheerchintala@LearnEra-Configuration/playbooks/roles/splunkforwarder/defaults/main.yml,0,1,0,0,0,0,1
2019-03-09 02:15:32.839862, /home/brokenquark/repo-ansi/sudheerchintala@LearnEra-Configuration/playbooks/roles/splunkforwarder/tasks/main.yml,1,0,0,0,0,0,1
2019-03-09 02:15:32.852950, /home/brokenquark/repo-ansi/sudheerchintala@LearnEra-Configuration/playbooks/roles/notifier/defaults/main.yml,2,2,0,0,0,0,4
2019-03-09 02:15:32.877035, /home/brokenquark/repo-ansi/sudheerchintala@LearnEra-Configuration/playbooks/roles/edx_ansible/defaults/main.yml,1,0,0,0,0,0,1
2019-03-09 02:15:32.900554, /home/brokenquark/repo-ansi/sudheerchintala@LearnEra-Configuration/playbooks/roles/snort/defaults/main.yml,0,0,2,0,0,1,3
2019-03-09 02:15:32.945113, /home/brokenquark/repo-ansi/sudheerchintala@LearnEra-Configuration/playbooks/roles/s3fs/defaults/main.yml,0,0,1,0,0,0,1
2019-03-09 02:15:32.954931, /home/brokenquark/repo-ansi/sudheerchintala@LearnEra-Configuration/playbooks/roles/mongo/defaults/main.yml,5,0,1,0,0,0,6
2019-03-09 02:15:33.046828, /home/brokenquark/repo-ansi/sudheerchintala@LearnEra-Configuration/playbooks/roles/edxapp/defaults/main.yml,92,2,4,0,1,0,99
2019-03-09 02:15:33.100682, /home/brokenquark/repo-ansi/sudheerchintala@LearnEra-Configuration/playbooks/roles/edxapp/tasks/deploy.yml,0,0,0,0,3,0,3
2019-03-09 02:15:33.141844, /home/brokenquark/repo-ansi/sudheerchintala@LearnEra-Configuration/playbooks/roles/rabbitmq/defaults/main.yml,5,0,2,0,0,1,8
2019-03-09 02:15:33.154518, /home/brokenquark/repo-ansi/sudheerchintala@LearnEra-Configuration/playbooks/roles/rabbitmq/tasks/main.yml,1,0,0,0,1,0,2
2019-03-09 02:15:33.163485, /home/brokenquark/repo-ansi/sudheerchintala@LearnEra-Configuration/playbooks/roles/analytics-server/defaults/main.yml,8,0,0,0,0,0,8
2019-03-09 02:15:33.196012, /home/brokenquark/repo-ansi/sudheerchintala@LearnEra-Configuration/playbooks/roles/insights/defaults/main.yml,4,0,1,0,0,0,5
2019-03-09 02:15:33.213716, /home/brokenquark/repo-ansi/sudheerchintala@LearnEra-Configuration/playbooks/roles/supervisor/defaults/main.yml,1,0,0,0,0,0,1
2019-03-09 02:15:33.228155, /home/brokenquark/repo-ansi/sudheerchintala@LearnEra-Configuration/playbooks/roles/browsers/defaults/main.yml,0,0,1,0,0,1,2
2019-03-09 02:15:33.234331, /home/brokenquark/repo-ansi/sudheerchintala@LearnEra-Configuration/playbooks/roles/nltk/defaults/main.yml,0,0,3,0,0,3,6
2019-03-09 02:15:33.248582, /home/brokenquark/repo-ansi/sudheerchintala@LearnEra-Configuration/playbooks/roles/discern/defaults/main.yml,5,0,1,0,0,1,7
2019-03-09 02:15:33.266205, /home/brokenquark/repo-ansi/sudheerchintala@LearnEra-Configuration/playbooks/roles/discern/tasks/main.yml,0,0,0,0,1,0,1
2019-03-09 02:15:33.326945, /home/brokenquark/repo-ansi/sudheerchintala@LearnEra-Configuration/playbooks/roles/xqwatcher/defaults/main.yml,5,0,0,0,0,0,5
2019-03-09 02:15:33.355182, /home/brokenquark/repo-ansi/sudheerchintala@LearnEra-Configuration/playbooks/roles/jenkins_worker/defaults/main.yml,1,0,1,0,0,2,4
2019-03-09 02:15:33.366485, /home/brokenquark/repo-ansi/sudheerchintala@LearnEra-Configuration/playbooks/roles/jenkins_worker/tasks/system.yml,0,0,0,0,2,0,2
2019-03-09 02:15:33.382765, /home/brokenquark/repo-ansi/sudheerchintala@LearnEra-Configuration/playbooks/roles/datadog/defaults/main.yml,1,0,1,0,0,0,2
2019-03-09 02:15:33.399612, /home/brokenquark/repo-ansi/sudheerchintala@LearnEra-Configuration/playbooks/roles/xqueue/defaults/main.yml,9,0,0,0,0,0,9
2019-03-09 02:15:33.427554, /home/brokenquark/repo-ansi/sudheerchintala@LearnEra-Configuration/playbooks/roles/nginx/defaults/main.yml,2,0,0,0,0,0,2
2019-03-09 02:15:33.446701, /home/brokenquark/repo-ansi/sudheerchintala@LearnEra-Configuration/playbooks/roles/shibboleth/defaults/main.yml,3,0,1,0,0,0,4
2019-03-09 02:15:33.464015, /home/brokenquark/repo-ansi/sudheerchintala@LearnEra-Configuration/playbooks/roles/local_dev/defaults/main.yml,1,0,0,0,0,0,1
2019-03-09 02:15:33.488609, /home/brokenquark/repo-ansi/sudheerchintala@LearnEra-Configuration/playbooks/edx-west/stage-worker.yml,1,0,0,0,0,0,1
2019-03-09 02:15:33.542903, /home/brokenquark/repo-ansi/sudheerchintala@LearnEra-Configuration/playbooks/edx-west/stage-notifier-only.yml,1,0,0,0,0,0,1
2019-03-09 02:15:33.654516, /home/brokenquark/repo-ansi/sudheerchintala@LearnEra-Configuration/playbooks/edx-east/edx_provision.yml,3,0,0,0,0,0,3
2019-03-09 02:15:33.661720, /home/brokenquark/repo-ansi/sudheerchintala@LearnEra-Configuration/playbooks/edx-east/add-ubuntu-key.yml,1,0,0,0,0,0,1
2019-03-09 02:15:33.703782, /home/brokenquark/repo-ansi/sudheerchintala@LearnEra-Configuration/playbooks/edx-east/remove-ubuntu-key.yml,1,0,0,0,0,0,1
2019-03-09 02:15:33.723661, /home/brokenquark/repo-ansi/sudheerchintala@LearnEra-Configuration/playbooks/edx-east/edx_notifier.yml,5,0,0,0,0,0,5
2019-03-09 02:15:33.751070, /home/brokenquark/repo-ansi/sudheerchintala@LearnEra-Configuration/playbooks/edx-east/ora2.yml,3,0,0,0,0,0,3
2019-03-09 02:15:33.783851, /home/brokenquark/repo-ansi/sudheerchintala@LearnEra-Configuration/playbooks/edx-east/create_dbs.yml,4,0,0,0,0,0,4
2019-03-09 02:15:33.791262, /home/brokenquark/repo-ansi/sudheerchintala@LearnEra-Configuration/playbooks/secure_example/vars/edxapp_ref_custom_vars.yml,2,0,0,0,0,0,2
2019-03-09 02:15:33.819005, /home/brokenquark/repo-ansi/sudheerchintala@LearnEra-Configuration/playbooks/secure_example/vars/edxapp_ref_vars.yml,34,0,0,0,0,0,34
2019-03-09 02:15:33.821454, /home/brokenquark/repo-ansi/sudheerchintala@LearnEra-Configuration/playbooks/secure_example/vars/edxapp_ref_users.yml,2,0,0,0,0,0,2
2019-03-09 02:15:33.824240, /home/brokenquark/repo-ansi/sudheerchintala@LearnEra-Configuration/playbooks/secure_example/vars/gerrit.yml,7,0,0,0,0,0,7
2019-03-09 02:15:57.501382, /home/brokenquark/repo-ansi/vccw-team@vccw/provision/playbooks/wordpress.yml,2,0,0,0,0,0,2
2019-03-09 02:15:57.521839, /home/brokenquark/repo-ansi/vccw-team@vccw/provision/playbooks/commands.yml,0,0,1,0,0,1,2
2019-03-09 02:16:34.346736, /home/brokenquark/repo-ansi/yanyao@newton/playbooks/etcd-install.yml,1,0,0,0,0,0,1
2019-03-09 02:16:34.355856, /home/brokenquark/repo-ansi/yanyao@newton/playbooks/memcached-install.yml,1,0,0,0,0,0,1
2019-03-09 02:16:34.359067, /home/brokenquark/repo-ansi/yanyao@newton/playbooks/openstack-hosts-setup.yml,1,0,0,0,0,0,1
2019-03-09 02:16:34.368011, /home/brokenquark/repo-ansi/yanyao@newton/playbooks/os-gnocchi-install.yml,2,0,0,0,0,0,2
2019-03-09 02:16:34.377137, /home/brokenquark/repo-ansi/yanyao@newton/playbooks/rabbitmq-install.yml,4,0,0,0,0,0,4
2019-03-09 02:16:34.392193, /home/brokenquark/repo-ansi/yanyao@newton/playbooks/os-keystone-install.yml,3,0,0,0,0,0,3
2019-03-09 02:16:34.405029, /home/brokenquark/repo-ansi/yanyao@newton/playbooks/os-glance-install.yml,2,0,0,0,0,0,2
2019-03-09 02:16:34.426102, /home/brokenquark/repo-ansi/yanyao@newton/playbooks/os-nova-install.yml,3,0,0,0,0,0,3
2019-03-09 02:16:34.428999, /home/brokenquark/repo-ansi/yanyao@newton/playbooks/os-swift-sync.yml,1,0,0,0,0,0,1
2019-03-09 02:16:34.434229, /home/brokenquark/repo-ansi/yanyao@newton/playbooks/ceph-osd.yml,1,0,0,0,0,0,1
2019-03-09 02:16:34.443323, /home/brokenquark/repo-ansi/yanyao@newton/playbooks/unbound-install.yml,2,0,0,0,0,0,2
2019-03-09 02:16:34.447618, /home/brokenquark/repo-ansi/yanyao@newton/playbooks/os-tempest-install.yml,1,0,0,0,0,0,1
2019-03-09 02:16:34.457690, /home/brokenquark/repo-ansi/yanyao@newton/playbooks/os-swift-install.yml,3,0,0,0,0,0,3
2019-03-09 02:16:34.472207, /home/brokenquark/repo-ansi/yanyao@newton/playbooks/repo-build.yml,1,0,0,0,0,0,1
2019-03-09 02:16:34.487074, /home/brokenquark/repo-ansi/yanyao@newton/playbooks/os-horizon-install.yml,2,0,0,0,0,0,2
2019-03-09 02:16:34.496992, /home/brokenquark/repo-ansi/yanyao@newton/playbooks/os-ceilometer-install.yml,1,0,0,0,0,0,1
2019-03-09 02:16:34.505118, /home/brokenquark/repo-ansi/yanyao@newton/playbooks/galera-install.yml,2,0,0,0,0,0,2
2019-03-09 02:16:34.509884, /home/brokenquark/repo-ansi/yanyao@newton/playbooks/os-rally-install.yml,1,0,0,0,0,0,1
2019-03-09 02:16:34.512239, /home/brokenquark/repo-ansi/yanyao@newton/playbooks/security-hardening.yml,1,0,0,0,0,0,1
2019-03-09 02:16:34.527779, /home/brokenquark/repo-ansi/yanyao@newton/playbooks/os-cinder-install.yml,2,0,0,0,0,0,2
2019-03-09 02:16:34.539138, /home/brokenquark/repo-ansi/yanyao@newton/playbooks/utility-install.yml,3,0,0,0,0,0,3
2019-03-09 02:16:34.544956, /home/brokenquark/repo-ansi/yanyao@newton/playbooks/rsyslog-install.yml,1,0,0,0,0,0,1
2019-03-09 02:16:34.552295, /home/brokenquark/repo-ansi/yanyao@newton/playbooks/os-magnum-install.yml,1,0,0,0,0,0,1
2019-03-09 02:16:34.568174, /home/brokenquark/repo-ansi/yanyao@newton/playbooks/os-neutron-install.yml,1,0,0,0,0,0,1
2019-03-09 02:16:34.578017, /home/brokenquark/repo-ansi/yanyao@newton/playbooks/os-heat-install.yml,2,0,0,0,0,0,2
2019-03-09 02:16:34.585189, /home/brokenquark/repo-ansi/yanyao@newton/playbooks/lxc-containers-destroy.yml,1,0,0,0,0,0,1
2019-03-09 02:16:34.593425, /home/brokenquark/repo-ansi/yanyao@newton/playbooks/os-aodh-install.yml,3,0,0,0,0,0,3
2019-03-09 02:16:34.603623, /home/brokenquark/repo-ansi/yanyao@newton/playbooks/ceph-mon.yml,2,0,0,0,0,0,2
2019-03-09 02:16:34.613139, /home/brokenquark/repo-ansi/yanyao@newton/playbooks/haproxy-install.yml,2,0,0,0,0,0,2
2019-03-09 02:16:34.617040, /home/brokenquark/repo-ansi/yanyao@newton/playbooks/lxc-containers-create.yml,1,0,0,0,0,0,1
2019-03-09 02:16:34.627423, /home/brokenquark/repo-ansi/yanyao@newton/playbooks/os-ironic-install.yml,2,0,0,0,0,0,2
2019-03-09 02:16:34.634593, /home/brokenquark/repo-ansi/yanyao@newton/playbooks/lxc-hosts-setup.yml,1,0,0,0,0,0,1
2019-03-09 02:16:34.642957, /home/brokenquark/repo-ansi/yanyao@newton/playbooks/repo-server.yml,1,0,0,0,0,0,1
2019-03-09 02:16:34.652129, /home/brokenquark/repo-ansi/yanyao@newton/playbooks/os-sahara-install.yml,1,0,0,0,0,0,1
2019-03-09 02:16:34.750023, /home/brokenquark/repo-ansi/yanyao@newton/playbooks/common-tasks/os-lxc-container-setup.yml,0,0,0,0,4,0,4
2019-03-09 02:16:34.765019, /home/brokenquark/repo-ansi/yanyao@newton/playbooks/roles/system_crontab_coordination/tasks/main.yml,1,0,0,0,0,0,1
2019-03-09 02:16:34.773045, /home/brokenquark/repo-ansi/yanyao@newton/playbooks/inventory/group_vars/utility_all.yml,1,0,0,0,0,0,1
2019-03-09 02:16:34.791599, /home/brokenquark/repo-ansi/yanyao@newton/playbooks/inventory/group_vars/horizon_all.yml,2,0,0,0,0,0,2
2019-03-09 02:16:34.793195, /home/brokenquark/repo-ansi/yanyao@newton/playbooks/inventory/group_vars/ironic_all.yml,1,0,0,0,0,0,1
2019-03-09 02:16:34.800234, /home/brokenquark/repo-ansi/yanyao@newton/playbooks/inventory/group_vars/magnum_all.yml,3,0,0,0,0,0,3
2019-03-09 02:16:34.862724, /home/brokenquark/repo-ansi/yanyao@newton/playbooks/inventory/group_vars/all.yml,31,0,0,0,1,0,32
2019-03-09 02:16:34.865199, /home/brokenquark/repo-ansi/yanyao@newton/playbooks/inventory/group_vars/neutron_all.yml,1,0,0,0,0,0,1
2019-03-09 02:16:34.868229, /home/brokenquark/repo-ansi/yanyao@newton/playbooks/inventory/group_vars/neutron_agent.yml,0,0,0,0,1,0,1
2019-03-09 02:16:34.871030, /home/brokenquark/repo-ansi/yanyao@newton/playbooks/inventory/group_vars/rabbitmq_all.yml,0,0,0,0,1,0,1
2019-03-09 02:16:34.877165, /home/brokenquark/repo-ansi/yanyao@newton/playbooks/inventory/group_vars/repo_all.yml,1,0,0,0,0,0,1
2019-03-09 02:16:35.068467, /home/brokenquark/repo-ansi/yanyao@newton/scripts/upgrade-utilities/playbooks/memcached-flush.yml,1,0,0,0,0,0,1
2019-03-09 02:16:35.074227, /home/brokenquark/repo-ansi/yanyao@newton/scripts/upgrade-utilities/playbooks/ceilometer-api-init-delete.yml,1,0,0,0,0,0,1
2019-03-09 02:16:35.076871, /home/brokenquark/repo-ansi/yanyao@newton/scripts/upgrade-utilities/playbooks/ansible_fact_cleanup.yml,1,0,0,0,0,0,1
2019-03-09 02:16:35.079070, /home/brokenquark/repo-ansi/yanyao@newton/scripts/upgrade-utilities/playbooks/mariadb-apt-cleanup.yml,1,0,0,0,0,0,1
2019-03-09 02:16:35.084537, /home/brokenquark/repo-ansi/yanyao@newton/scripts/upgrade-utilities/playbooks/db-collation-alter.yml,1,0,0,0,0,0,1
2019-03-09 02:16:35.091196, /home/brokenquark/repo-ansi/yanyao@newton/scripts/upgrade-utilities/playbooks/galera-cluster-rolling-restart.yml,1,0,0,0,0,0,1
2019-03-09 02:16:35.097110, /home/brokenquark/repo-ansi/yanyao@newton/scripts/upgrade-utilities/playbooks/user-secrets-adjustment.yml,1,0,0,0,0,0,1
2019-03-09 02:16:35.119204, /home/brokenquark/repo-ansi/yanyao@newton/scripts/upgrade-utilities/playbooks/pip-conf-removal.yml,1,0,0,0,0,0,1
2019-03-09 02:16:35.124760, /home/brokenquark/repo-ansi/yanyao@newton/scripts/upgrade-utilities/playbooks/aodh-api-init-delete.yml,1,0,0,0,0,0,1
2019-03-09 02:16:35.132064, /home/brokenquark/repo-ansi/yanyao@newton/scripts/upgrade-utilities/playbooks/deploy-config-changes.yml,2,0,0,0,0,0,2
2019-03-09 02:16:35.134745, /home/brokenquark/repo-ansi/yanyao@openstack-deployment/rpc_deployment/playbooks/deprecated.yml,1,0,0,0,0,0,1
2019-03-09 02:16:35.136074, /home/brokenquark/repo-ansi/yanyao@openstack-deployment/rpc_deployment/playbooks/deprecated/deprecated.yml,1,0,0,0,0,0,1
2019-03-09 02:16:35.277519, /home/brokenquark/repo-ansi/yanyao@openstack-deployment/playbooks/elasticsearch.yml,2,0,0,0,0,0,2
2019-03-09 02:16:35.283352, /home/brokenquark/repo-ansi/yanyao@openstack-deployment/playbooks/memcached-install.yml,1,0,0,0,0,0,1
2019-03-09 02:16:35.287234, /home/brokenquark/repo-ansi/yanyao@openstack-deployment/playbooks/repo-clone-mirror.yml,1,0,0,0,0,0,1
2019-03-09 02:16:35.289158, /home/brokenquark/repo-ansi/yanyao@openstack-deployment/playbooks/openstack-hosts-setup.yml,1,0,0,0,0,0,1
2019-03-09 02:16:35.291964, /home/brokenquark/repo-ansi/yanyao@openstack-deployment/playbooks/repo-store-source.yml,1,0,0,0,0,0,1
2019-03-09 02:16:35.298691, /home/brokenquark/repo-ansi/yanyao@openstack-deployment/playbooks/rabbitmq-install.yml,1,0,0,0,0,0,1
2019-03-09 02:16:35.311889, /home/brokenquark/repo-ansi/yanyao@openstack-deployment/playbooks/os-keystone-install.yml,1,0,0,0,0,0,1
2019-03-09 02:16:35.326303, /home/brokenquark/repo-ansi/yanyao@openstack-deployment/playbooks/beaver.yml,1,0,0,0,0,0,1
2019-03-09 02:16:35.339784, /home/brokenquark/repo-ansi/yanyao@openstack-deployment/playbooks/os-glance-install.yml,1,0,0,0,0,0,1
2019-03-09 02:16:35.343459, /home/brokenquark/repo-ansi/yanyao@openstack-deployment/playbooks/haproxy.yml,1,0,0,0,0,0,1
2019-03-09 02:16:35.364806, /home/brokenquark/repo-ansi/yanyao@openstack-deployment/playbooks/os-nova-install.yml,1,0,0,0,0,0,1
2019-03-09 02:16:35.367831, /home/brokenquark/repo-ansi/yanyao@openstack-deployment/playbooks/os-swift-sync.yml,1,0,0,0,0,0,1
2019-03-09 02:16:35.369559, /home/brokenquark/repo-ansi/yanyao@openstack-deployment/playbooks/logstash.yml,1,0,0,0,0,0,1
2019-03-09 02:16:35.374651, /home/brokenquark/repo-ansi/yanyao@openstack-deployment/playbooks/ceph-osd.yml,1,0,0,0,0,0,1
2019-03-09 02:16:35.384634, /home/brokenquark/repo-ansi/yanyao@openstack-deployment/playbooks/os-swift-setup.yml,2,0,0,0,0,0,2
2019-03-09 02:16:35.388533, /home/brokenquark/repo-ansi/yanyao@openstack-deployment/playbooks/os-tempest-install.yml,1,0,0,0,0,0,1
2019-03-09 02:16:35.399665, /home/brokenquark/repo-ansi/yanyao@openstack-deployment/playbooks/repo-build.yml,1,0,0,0,0,0,1
2019-03-09 02:16:35.413516, /home/brokenquark/repo-ansi/yanyao@openstack-deployment/playbooks/os-horizon-install.yml,1,0,0,0,0,0,1
2019-03-09 02:16:35.431493, /home/brokenquark/repo-ansi/yanyao@openstack-deployment/playbooks/os-ceilometer-install.yml,1,0,0,0,0,0,1
2019-03-09 02:16:35.434045, /home/brokenquark/repo-ansi/yanyao@openstack-deployment/playbooks/kibana.yml,1,0,0,0,0,0,1
2019-03-09 02:16:35.450069, /home/brokenquark/repo-ansi/yanyao@openstack-deployment/playbooks/galera-install.yml,1,0,0,0,0,0,1
2019-03-09 02:16:35.471060, /home/brokenquark/repo-ansi/yanyao@openstack-deployment/playbooks/os-cinder-install.yml,1,0,0,0,0,0,1
2019-03-09 02:16:35.484673, /home/brokenquark/repo-ansi/yanyao@openstack-deployment/playbooks/utility-install.yml,3,0,0,0,0,0,3
2019-03-09 02:16:35.494742, /home/brokenquark/repo-ansi/yanyao@openstack-deployment/playbooks/rsyslog-install.yml,1,0,0,0,0,0,1
2019-03-09 02:16:35.510256, /home/brokenquark/repo-ansi/yanyao@openstack-deployment/playbooks/os-neutron-install.yml,1,0,0,0,0,0,1
2019-03-09 02:16:35.521217, /home/brokenquark/repo-ansi/yanyao@openstack-deployment/playbooks/os-heat-install.yml,1,0,0,0,0,0,1
2019-03-09 02:16:35.525347, /home/brokenquark/repo-ansi/yanyao@openstack-deployment/playbooks/lxc-containers-destroy.yml,1,0,0,0,0,0,1
2019-03-09 02:16:35.529018, /home/brokenquark/repo-ansi/yanyao@openstack-deployment/playbooks/ceph-mon.yml,1,0,0,0,0,0,1
2019-03-09 02:16:35.535440, /home/brokenquark/repo-ansi/yanyao@openstack-deployment/playbooks/haproxy-install.yml,1,0,0,0,0,0,1
2019-03-09 02:16:35.539323, /home/brokenquark/repo-ansi/yanyao@openstack-deployment/playbooks/lxc-containers-create.yml,1,0,0,0,0,0,1
2019-03-09 02:16:35.543059, /home/brokenquark/repo-ansi/yanyao@openstack-deployment/playbooks/lxc-hosts-setup.yml,1,0,0,0,0,0,1
2019-03-09 02:16:35.551220, /home/brokenquark/repo-ansi/yanyao@openstack-deployment/playbooks/repo-server.yml,1,0,0,0,0,0,1
2019-03-09 02:16:35.574699, /home/brokenquark/repo-ansi/yanyao@openstack-deployment/playbooks/vars/configs/haproxy_config.yml,1,0,0,0,0,0,1
2019-03-09 02:16:35.599195, /home/brokenquark/repo-ansi/yanyao@openstack-deployment/playbooks/roles/lxc_hosts/defaults/main.yml,4,0,0,0,2,0,6
2019-03-09 02:16:35.610025, /home/brokenquark/repo-ansi/yanyao@openstack-deployment/playbooks/roles/lxc_hosts/tasks/lxc_pre_install.yml,1,0,0,0,0,0,1
2019-03-09 02:16:35.652820, /home/brokenquark/repo-ansi/yanyao@openstack-deployment/playbooks/roles/system_crontab_coordination/tasks/main.yml,1,0,0,0,0,0,1
2019-03-09 02:16:35.671513, /home/brokenquark/repo-ansi/yanyao@openstack-deployment/playbooks/roles/os_swift/defaults/main.yml,6,0,0,0,0,0,6
2019-03-09 02:16:35.704572, /home/brokenquark/repo-ansi/yanyao@openstack-deployment/playbooks/roles/os_swift/tasks/swift_pre_install.yml,4,0,0,0,0,0,4
2019-03-09 02:16:35.741939, /home/brokenquark/repo-ansi/yanyao@openstack-deployment/playbooks/roles/os_swift/tasks/swift_upstart_common_init.yml,1,0,0,0,0,0,1
2019-03-09 02:16:35.756757, /home/brokenquark/repo-ansi/yanyao@openstack-deployment/playbooks/roles/os_swift/tasks/swift_storage_hosts_setup.yml,2,0,0,0,0,0,2
2019-03-09 02:16:35.809837, /home/brokenquark/repo-ansi/yanyao@openstack-deployment/playbooks/roles/memcached_server/defaults/main.yml,1,0,0,0,0,0,1
2019-03-09 02:16:35.815745, /home/brokenquark/repo-ansi/yanyao@openstack-deployment/playbooks/roles/memcached_server/tasks/memcached_config.yml,2,0,0,0,0,0,2
2019-03-09 02:16:35.830437, /home/brokenquark/repo-ansi/yanyao@openstack-deployment/playbooks/roles/elasticsearch/defaults/main.yml,0,0,2,0,0,0,2
2019-03-09 02:16:35.838811, /home/brokenquark/repo-ansi/yanyao@openstack-deployment/playbooks/roles/elasticsearch/templates/elasticsearch.yml,0,0,0,0,6,0,6
2019-03-09 02:16:35.860845, /home/brokenquark/repo-ansi/yanyao@openstack-deployment/playbooks/roles/elasticsearch/tasks/elasticsearch_post_install.yml,4,0,0,0,0,0,4
2019-03-09 02:16:35.869033, /home/brokenquark/repo-ansi/yanyao@openstack-deployment/playbooks/roles/logstash/defaults/main.yml,0,0,1,0,0,0,1
2019-03-09 02:16:35.880829, /home/brokenquark/repo-ansi/yanyao@openstack-deployment/playbooks/roles/logstash/tasks/logstash_post_install.yml,4,0,0,0,0,0,4
2019-03-09 02:16:35.898333, /home/brokenquark/repo-ansi/yanyao@openstack-deployment/playbooks/roles/ceph-mon/defaults/main.yml,1,0,0,0,0,0,1
2019-03-09 02:16:35.930350, /home/brokenquark/repo-ansi/yanyao@openstack-deployment/playbooks/roles/ceph-mon/tasks/ceph_keys.yml,2,0,0,0,0,0,2
2019-03-09 02:16:35.934848, /home/brokenquark/repo-ansi/yanyao@openstack-deployment/playbooks/roles/ceph-mon/tasks/docker/fetch_configs.yml,1,0,0,0,0,0,1
2019-03-09 02:16:35.950463, /home/brokenquark/repo-ansi/yanyao@openstack-deployment/playbooks/roles/ceph-mon/tasks/docker/pre_requisite.yml,0,0,0,0,1,0,1
2019-03-09 02:16:35.969491, /home/brokenquark/repo-ansi/yanyao@openstack-deployment/playbooks/roles/os_glance/defaults/main.yml,5,0,0,2,0,0,7
2019-03-09 02:16:35.973455, /home/brokenquark/repo-ansi/yanyao@openstack-deployment/playbooks/roles/os_glance/tasks/glance_upstart_common_init.yml,1,0,0,0,0,0,1
2019-03-09 02:16:35.987612, /home/brokenquark/repo-ansi/yanyao@openstack-deployment/playbooks/roles/os_glance/tasks/glance_pre_install.yml,1,0,0,0,0,0,1
2019-03-09 02:16:36.017696, /home/brokenquark/repo-ansi/yanyao@openstack-deployment/playbooks/roles/os_glance/tasks/glance_post_install.yml,1,0,0,0,0,0,1
2019-03-09 02:16:36.045483, /home/brokenquark/repo-ansi/yanyao@openstack-deployment/playbooks/roles/galera_client/defaults/main.yml,2,0,0,0,0,0,2
2019-03-09 02:16:36.057415, /home/brokenquark/repo-ansi/yanyao@openstack-deployment/playbooks/roles/galera_client/tasks/galera_client_post_install.yml,1,0,0,0,0,0,1
2019-03-09 02:16:36.072633, /home/brokenquark/repo-ansi/yanyao@openstack-deployment/playbooks/roles/openstack_hosts/defaults/main.yml,21,0,0,0,0,0,21
2019-03-09 02:16:36.079570, /home/brokenquark/repo-ansi/yanyao@openstack-deployment/playbooks/roles/openstack_hosts/tasks/openstack_lvm_config.yml,1,0,0,0,0,0,1
2019-03-09 02:16:36.112809, /home/brokenquark/repo-ansi/yanyao@openstack-deployment/playbooks/roles/openstack_hosts/tasks/openstack_release.yml,1,0,0,0,0,0,1
2019-03-09 02:16:36.126263, /home/brokenquark/repo-ansi/yanyao@openstack-deployment/playbooks/roles/os_swift_sync/defaults/main.yml,1,0,0,0,0,0,1
2019-03-09 02:16:36.142425, /home/brokenquark/repo-ansi/yanyao@openstack-deployment/playbooks/roles/os_swift_sync/tasks/swift_rings_distribute.yml,2,0,0,0,0,0,2
2019-03-09 02:16:36.208236, /home/brokenquark/repo-ansi/yanyao@openstack-deployment/playbooks/roles/os_nova/defaults/main.yml,10,0,0,0,0,0,10
2019-03-09 02:16:36.229750, /home/brokenquark/repo-ansi/yanyao@openstack-deployment/playbooks/roles/os_nova/tasks/nova_pre_install.yml,5,0,0,0,0,0,5
2019-03-09 02:16:36.299597, /home/brokenquark/repo-ansi/yanyao@openstack-deployment/playbooks/roles/os_nova/tasks/nova_post_install.yml,2,0,0,0,0,0,2
2019-03-09 02:16:36.317101, /home/brokenquark/repo-ansi/yanyao@openstack-deployment/playbooks/roles/os_nova/tasks/nova_upstart_common_init.yml,1,0,0,0,0,0,1
2019-03-09 02:16:36.327092, /home/brokenquark/repo-ansi/yanyao@openstack-deployment/playbooks/roles/ceph-osd/defaults/main.yml,2,0,0,0,0,0,2
2019-03-09 02:16:36.336134, /home/brokenquark/repo-ansi/yanyao@openstack-deployment/playbooks/roles/ceph-osd/tasks/osd_fragment.yml,3,0,0,0,0,0,3
2019-03-09 02:16:36.346775, /home/brokenquark/repo-ansi/yanyao@openstack-deployment/playbooks/roles/ceph-osd/tasks/pre_requisite.yml,1,0,0,0,0,0,1
2019-03-09 02:16:36.369403, /home/brokenquark/repo-ansi/yanyao@openstack-deployment/playbooks/roles/ceph-osd/tasks/check_devices.yml,0,0,0,0,3,0,3
2019-03-09 02:16:36.372856, /home/brokenquark/repo-ansi/yanyao@openstack-deployment/playbooks/roles/ceph-osd/tasks/docker/fetch_configs.yml,1,0,0,0,0,0,1
2019-03-09 02:16:36.380456, /home/brokenquark/repo-ansi/yanyao@openstack-deployment/playbooks/roles/ceph-osd/tasks/docker/start_docker_osd.yml,1,0,0,0,0,0,1
2019-03-09 02:16:36.386371, /home/brokenquark/repo-ansi/yanyao@openstack-deployment/playbooks/roles/ceph-osd/tasks/docker/pre_requisite.yml,0,0,0,0,1,0,1
2019-03-09 02:16:36.409347, /home/brokenquark/repo-ansi/yanyao@openstack-deployment/playbooks/roles/os_horizon/defaults/main.yml,7,0,1,0,0,0,8
2019-03-09 02:16:36.434449, /home/brokenquark/repo-ansi/yanyao@openstack-deployment/playbooks/roles/os_horizon/tasks/horizon_apache.yml,1,0,0,0,0,0,1
2019-03-09 02:16:36.467656, /home/brokenquark/repo-ansi/yanyao@openstack-deployment/playbooks/roles/os_horizon/tasks/horizon_ssl_user_provided.yml,2,0,0,0,0,0,2
2019-03-09 02:16:36.485306, /home/brokenquark/repo-ansi/yanyao@openstack-deployment/playbooks/roles/rabbitmq_server/defaults/main.yml,5,0,0,0,0,1,6
2019-03-09 02:16:36.494605, /home/brokenquark/repo-ansi/yanyao@openstack-deployment/playbooks/roles/rabbitmq_server/tasks/rabbitmq_post_install.yml,2,0,0,0,1,0,3
2019-03-09 02:16:36.500253, /home/brokenquark/repo-ansi/yanyao@openstack-deployment/playbooks/roles/rabbitmq_server/tasks/rabbitmq_ssl_key_distribute.yml,1,0,0,0,1,0,2
2019-03-09 02:16:36.508214, /home/brokenquark/repo-ansi/yanyao@openstack-deployment/playbooks/roles/rabbitmq_server/tasks/rabbitmq_ssl_user_provided.yml,2,0,0,0,0,0,2
2019-03-09 02:16:36.512359, /home/brokenquark/repo-ansi/yanyao@openstack-deployment/playbooks/roles/rabbitmq_server/tasks/rabbitmq_set_cookie.yml,1,0,0,0,0,0,1
2019-03-09 02:16:36.535136, /home/brokenquark/repo-ansi/yanyao@openstack-deployment/playbooks/roles/rabbitmq_server/tasks/rabbitmq_ssl_key_create.yml,1,0,0,0,0,0,1
2019-03-09 02:16:36.560225, /home/brokenquark/repo-ansi/yanyao@openstack-deployment/playbooks/roles/haproxy_rpc/tasks/main.yml,1,0,0,0,0,0,1
2019-03-09 02:16:36.566713, /home/brokenquark/repo-ansi/yanyao@openstack-deployment/playbooks/roles/openstack_openrc/defaults/main.yml,1,0,0,0,0,0,1
2019-03-09 02:16:36.595582, /home/brokenquark/repo-ansi/yanyao@openstack-deployment/playbooks/roles/os_keystone/defaults/main.yml,7,0,0,1,0,0,8
2019-03-09 02:16:36.610112, /home/brokenquark/repo-ansi/yanyao@openstack-deployment/playbooks/roles/os_keystone/tasks/keystone_pre_install.yml,4,0,0,0,0,0,4
2019-03-09 02:16:36.618700, /home/brokenquark/repo-ansi/yanyao@openstack-deployment/playbooks/roles/os_keystone/tasks/keystone_post_install.yml,1,0,0,0,0,0,1
2019-03-09 02:16:36.623466, /home/brokenquark/repo-ansi/yanyao@openstack-deployment/playbooks/roles/os_keystone/tasks/keystone_ssl_user_provided.yml,2,0,0,0,0,0,2
2019-03-09 02:16:36.635613, /home/brokenquark/repo-ansi/yanyao@openstack-deployment/playbooks/roles/os_keystone/tasks/keystone_federation_sp_setup.yml,1,0,0,0,0,0,1
2019-03-09 02:16:36.661195, /home/brokenquark/repo-ansi/yanyao@openstack-deployment/playbooks/roles/os_keystone/tasks/keystone_apache.yml,1,0,0,0,0,0,1
2019-03-09 02:16:36.835534, /home/brokenquark/repo-ansi/yanyao@openstack-deployment/playbooks/roles/os_keystone/tasks/keystone_fernet_keys_autorotate.yml,1,0,0,0,0,0,1
2019-03-09 02:16:36.853670, /home/brokenquark/repo-ansi/yanyao@openstack-deployment/playbooks/roles/kibana/defaults/main.yml,4,0,0,0,0,0,4
2019-03-09 02:16:36.882026, /home/brokenquark/repo-ansi/yanyao@openstack-deployment/playbooks/roles/kibana/tasks/kibana_post_install.yml,3,1,0,0,0,0,4
2019-03-09 02:16:36.892567, /home/brokenquark/repo-ansi/yanyao@openstack-deployment/playbooks/roles/lxc_container_create/defaults/main.yml,1,0,0,0,0,0,1
2019-03-09 02:16:36.917918, /home/brokenquark/repo-ansi/yanyao@openstack-deployment/playbooks/roles/lxc_container_create/tasks/container_create.yml,2,0,0,0,2,0,4
2019-03-09 02:16:36.932789, /home/brokenquark/repo-ansi/yanyao@openstack-deployment/playbooks/roles/haproxy_server/defaults/main.yml,7,0,1,0,0,0,8
2019-03-09 02:16:36.953082, /home/brokenquark/repo-ansi/yanyao@openstack-deployment/playbooks/roles/haproxy_server/tasks/haproxy_ssl_configuration.yml,2,0,0,0,0,0,2
2019-03-09 02:16:36.996093, /home/brokenquark/repo-ansi/yanyao@openstack-deployment/playbooks/roles/ceph-common/defaults/main.yml,4,0,1,1,3,0,9
2019-03-09 02:16:37.017025, /home/brokenquark/repo-ansi/yanyao@openstack-deployment/playbooks/roles/ceph-common/tasks/main.yml,8,0,0,0,0,0,8
2019-03-09 02:16:37.059411, /home/brokenquark/repo-ansi/yanyao@openstack-deployment/playbooks/roles/ceph-common/tasks/pre_requisites/prerequisite_ice.yml,1,0,0,0,0,0,1
2019-03-09 02:16:37.064465, /home/brokenquark/repo-ansi/yanyao@openstack-deployment/playbooks/roles/ceph-common/tasks/pre_requisites/prerequisite_rh_storage_iso_install.yml,1,0,0,0,0,0,1
2019-03-09 02:16:37.076888, /home/brokenquark/repo-ansi/yanyao@openstack-deployment/playbooks/roles/ceph-common/tasks/installs/install_rgw_on_redhat.yml,4,0,1,0,0,0,5
2019-03-09 02:16:37.083461, /home/brokenquark/repo-ansi/yanyao@openstack-deployment/playbooks/roles/ceph-common/tasks/installs/install_on_debian.yml,1,0,0,0,0,0,1
2019-03-09 02:16:37.099564, /home/brokenquark/repo-ansi/yanyao@openstack-deployment/playbooks/roles/ceph-common/tasks/installs/install_on_redhat.yml,1,0,0,0,0,0,1
2019-03-09 02:16:37.116578, /home/brokenquark/repo-ansi/yanyao@openstack-deployment/playbooks/roles/ceph-common/tasks/installs/install_rgw_on_debian.yml,3,0,0,0,0,0,3
2019-03-09 02:16:37.126093, /home/brokenquark/repo-ansi/yanyao@openstack-deployment/playbooks/roles/ceph-common/tasks/installs/redhat_ceph_repository.yml,2,0,4,0,0,0,6
2019-03-09 02:16:37.161914, /home/brokenquark/repo-ansi/yanyao@openstack-deployment/playbooks/roles/os_heat/defaults/main.yml,5,0,0,0,0,0,5
2019-03-09 02:16:37.166856, /home/brokenquark/repo-ansi/yanyao@openstack-deployment/playbooks/roles/os_heat/tasks/heat_upstart_common_init.yml,1,0,0,0,0,0,1
2019-03-09 02:16:37.213750, /home/brokenquark/repo-ansi/yanyao@openstack-deployment/playbooks/roles/os_heat/tasks/heat_pre_install.yml,1,0,0,0,0,0,1
2019-03-09 02:16:37.251703, /home/brokenquark/repo-ansi/yanyao@openstack-deployment/playbooks/roles/ceph_client/defaults/main.yml,3,0,0,0,0,0,3
2019-03-09 02:16:37.261227, /home/brokenquark/repo-ansi/yanyao@openstack-deployment/playbooks/roles/ceph_client/tasks/ceph_config.yml,2,0,0,0,0,0,2
2019-03-09 02:16:37.289842, /home/brokenquark/repo-ansi/yanyao@openstack-deployment/playbooks/roles/ceph_client/tasks/ceph_auth.yml,1,0,0,0,0,0,1
2019-03-09 02:16:37.307931, /home/brokenquark/repo-ansi/yanyao@openstack-deployment/playbooks/roles/galera_server/defaults/main.yml,3,1,0,0,1,0,5
2019-03-09 02:16:37.319367, /home/brokenquark/repo-ansi/yanyao@openstack-deployment/playbooks/roles/galera_server/tasks/galera_post_install.yml,3,0,0,0,0,0,3
2019-03-09 02:16:37.359856, /home/brokenquark/repo-ansi/yanyao@openstack-deployment/playbooks/roles/os_ceilometer/defaults/main.yml,3,0,0,1,0,0,4
2019-03-09 02:16:37.381860, /home/brokenquark/repo-ansi/yanyao@openstack-deployment/playbooks/roles/os_ceilometer/tasks/ceilometer_pre_install.yml,2,0,0,0,0,0,2
2019-03-09 02:16:37.387665, /home/brokenquark/repo-ansi/yanyao@openstack-deployment/playbooks/roles/os_ceilometer/tasks/ceilometer_upstart_common_init.yml,1,0,0,0,0,0,1
2019-03-09 02:16:37.397467, /home/brokenquark/repo-ansi/yanyao@openstack-deployment/playbooks/roles/os_ceilometer/tasks/ceilometer_post_install.yml,2,0,0,0,0,0,2
2019-03-09 02:16:37.458112, /home/brokenquark/repo-ansi/yanyao@openstack-deployment/playbooks/roles/os_neutron/defaults/main.yml,6,0,0,0,0,0,6
2019-03-09 02:16:37.509862, /home/brokenquark/repo-ansi/yanyao@openstack-deployment/playbooks/roles/os_neutron/tasks/neutron_upstart_common_init.yml,1,0,0,0,0,0,1
2019-03-09 02:16:37.552663, /home/brokenquark/repo-ansi/yanyao@openstack-deployment/playbooks/roles/os_neutron/tasks/neutron_post_install.yml,4,0,0,0,0,0,4
2019-03-09 02:16:37.574536, /home/brokenquark/repo-ansi/yanyao@openstack-deployment/playbooks/roles/os_neutron/tasks/neutron_l3_ha.yml,3,0,0,0,0,0,3
2019-03-09 02:16:37.595429, /home/brokenquark/repo-ansi/yanyao@openstack-deployment/playbooks/roles/os_neutron/tasks/neutron_pre_install.yml,3,0,0,0,0,0,3
2019-03-09 02:16:37.624588, /home/brokenquark/repo-ansi/yanyao@openstack-deployment/playbooks/roles/rsyslog_server/tasks/rsyslog_server_post_install.yml,2,0,0,0,0,0,2
2019-03-09 02:16:37.627315, /home/brokenquark/repo-ansi/yanyao@openstack-deployment/playbooks/roles/rsyslog_server/tasks/rsyslog_server_pre_install.yml,1,0,0,0,0,0,1
2019-03-09 02:16:37.661203, /home/brokenquark/repo-ansi/yanyao@openstack-deployment/playbooks/roles/ceph.ceph-common/defaults/main.yml,4,0,1,1,3,0,9
2019-03-09 02:16:37.684347, /home/brokenquark/repo-ansi/yanyao@openstack-deployment/playbooks/roles/ceph.ceph-common/tasks/main.yml,8,0,0,0,0,0,8
2019-03-09 02:16:37.728057, /home/brokenquark/repo-ansi/yanyao@openstack-deployment/playbooks/roles/ceph.ceph-common/tasks/pre_requisites/prerequisite_ice.yml,1,0,0,0,0,0,1
2019-03-09 02:16:37.733383, /home/brokenquark/repo-ansi/yanyao@openstack-deployment/playbooks/roles/ceph.ceph-common/tasks/pre_requisites/prerequisite_rh_storage_iso_install.yml,1,0,0,0,0,0,1
2019-03-09 02:16:37.746073, /home/brokenquark/repo-ansi/yanyao@openstack-deployment/playbooks/roles/ceph.ceph-common/tasks/installs/install_rgw_on_redhat.yml,4,0,1,0,0,0,5
2019-03-09 02:16:37.753035, /home/brokenquark/repo-ansi/yanyao@openstack-deployment/playbooks/roles/ceph.ceph-common/tasks/installs/install_on_debian.yml,1,0,0,0,0,0,1
2019-03-09 02:16:37.771487, /home/brokenquark/repo-ansi/yanyao@openstack-deployment/playbooks/roles/ceph.ceph-common/tasks/installs/install_on_redhat.yml,1,0,0,0,0,0,1
2019-03-09 02:16:37.789585, /home/brokenquark/repo-ansi/yanyao@openstack-deployment/playbooks/roles/ceph.ceph-common/tasks/installs/install_rgw_on_debian.yml,3,0,0,0,0,0,3
2019-03-09 02:16:37.802411, /home/brokenquark/repo-ansi/yanyao@openstack-deployment/playbooks/roles/ceph.ceph-common/tasks/installs/redhat_ceph_repository.yml,2,0,4,0,0,0,6
2019-03-09 02:16:37.833896, /home/brokenquark/repo-ansi/yanyao@openstack-deployment/playbooks/roles/os_tempest/defaults/main.yml,7,0,1,0,0,0,8
2019-03-09 02:16:37.879562, /home/brokenquark/repo-ansi/yanyao@openstack-deployment/playbooks/roles/os_tempest/tasks/tempest_post_install.yml,3,0,0,0,0,0,3
2019-03-09 02:16:37.896995, /home/brokenquark/repo-ansi/yanyao@openstack-deployment/playbooks/roles/repo_server/defaults/main.yml,1,0,0,0,0,0,1
2019-03-09 02:16:37.920045, /home/brokenquark/repo-ansi/yanyao@openstack-deployment/playbooks/roles/repo_server/tasks/repo_pre_install.yml,1,0,0,0,0,0,1
2019-03-09 02:16:37.944650, /home/brokenquark/repo-ansi/yanyao@openstack-deployment/playbooks/roles/repo_server/tasks/repo_post_install.yml,2,0,0,0,0,0,2
2019-03-09 02:16:37.989157, /home/brokenquark/repo-ansi/yanyao@openstack-deployment/playbooks/roles/os_cinder/defaults/main.yml,7,0,0,0,0,0,7
2019-03-09 02:16:38.000793, /home/brokenquark/repo-ansi/yanyao@openstack-deployment/playbooks/roles/os_cinder/tasks/cinder_pre_install.yml,3,0,0,0,0,0,3
2019-03-09 02:16:38.005072, /home/brokenquark/repo-ansi/yanyao@openstack-deployment/playbooks/roles/os_cinder/tasks/cinder_lvm_config.yml,1,0,0,0,0,0,1
2019-03-09 02:16:38.015535, /home/brokenquark/repo-ansi/yanyao@openstack-deployment/playbooks/roles/os_cinder/tasks/cinder_upstart_common_init.yml,1,0,0,0,0,0,1
2019-03-09 02:16:38.057558, /home/brokenquark/repo-ansi/yanyao@openstack-deployment/playbooks/roles/os_cinder/tasks/cinder_post_install.yml,2,0,0,0,0,0,2
2019-03-09 02:16:38.073145, /home/brokenquark/repo-ansi/yanyao@openstack-deployment/playbooks/roles/rsyslog_client/tasks/rsyslog_client_pre_install.yml,1,0,0,0,0,0,1
2019-03-09 02:16:38.081552, /home/brokenquark/repo-ansi/yanyao@openstack-deployment/playbooks/roles/rsyslog_client/tasks/rsyslog_client_post_install.yml,2,0,0,0,0,0,2
2019-03-09 02:16:38.094892, /home/brokenquark/repo-ansi/yanyao@openstack-deployment/playbooks/roles/beaver/defaults/main.yml,2,0,0,0,0,0,2
2019-03-09 02:16:38.111335, /home/brokenquark/repo-ansi/yanyao@openstack-deployment/playbooks/roles/beaver/tasks/beaver_install.yml,2,0,0,0,0,0,2
2019-03-09 02:16:38.138139, /home/brokenquark/repo-ansi/yanyao@openstack-deployment/playbooks/inventory/group_vars/all_containers.yml,16,0,0,0,0,0,16
2019-03-09 02:16:38.162773, /home/brokenquark/repo-ansi/yanyao@openstack-deployment/playbooks/inventory/group_vars/hosts.yml,16,0,0,0,0,0,16
2019-03-09 02:16:38.662400, /home/brokenquark/repo-ansi/yanyao@openstack-deployment/scripts/upgrade-utilities/playbooks/swift-repo-adjustments.yml,1,0,0,0,0,0,1
2019-03-09 02:16:38.666321, /home/brokenquark/repo-ansi/yanyao@openstack-deployment/scripts/upgrade-utilities/playbooks/nova-extra-migrations.yml,1,0,0,0,0,0,1
2019-03-09 02:16:38.669963, /home/brokenquark/repo-ansi/yanyao@openstack-deployment/scripts/upgrade-utilities/playbooks/container-network-adjustments.yml,1,0,0,0,0,0,1
2019-03-09 02:16:38.673847, /home/brokenquark/repo-ansi/yanyao@openstack-deployment/scripts/upgrade-utilities/playbooks/user-secrets-adjustments.yml,1,0,0,0,0,0,1
2019-03-09 02:16:38.676474, /home/brokenquark/repo-ansi/yanyao@openstack-deployment/scripts/upgrade-utilities/playbooks/keystone-adjustments.yml,1,0,0,0,0,0,1
2019-03-09 02:16:38.685141, /home/brokenquark/repo-ansi/yanyao@openstack-deployment/scripts/upgrade-utilities/playbooks/host-adjustments.yml,1,0,0,0,0,0,1
2019-03-09 02:16:38.692185, /home/brokenquark/repo-ansi/yanyao@openstack-deployment/scripts/upgrade-utilities/playbooks/swift-ring-adjustments.yml,2,0,0,0,0,0,2
2019-03-09 02:16:38.696624, /home/brokenquark/repo-ansi/yanyao@openstack-deployment/scripts/upgrade-utilities/playbooks/cinder-adjustments.yml,1,0,0,0,0,0,1
2019-03-09 02:16:38.701678, /home/brokenquark/repo-ansi/yanyao@openstack-deployment/scripts/upgrade-utilities/playbooks/horizon-adjustments.yml,2,0,0,0,0,0,2
2019-03-09 02:16:38.706184, /home/brokenquark/repo-ansi/yanyao@openstack-deployment/scripts/upgrade-utilities/playbooks/container-network-bounce.yml,1,0,0,0,0,0,1
2019-03-09 02:16:38.710727, /home/brokenquark/repo-ansi/yanyao@openstack-deployment/scripts/upgrade-utilities/playbooks/remove-juno-log-rotate.yml,1,0,0,0,0,0,1
2019-03-09 02:16:38.724909, /home/brokenquark/repo-ansi/yanyao@openstack-deployment-liberty/playbooks/memcached-install.yml,1,0,0,0,0,0,1
2019-03-09 02:16:38.732789, /home/brokenquark/repo-ansi/yanyao@openstack-deployment-liberty/playbooks/repo-clone-mirror.yml,2,0,0,0,0,0,2
2019-03-09 02:16:38.735058, /home/brokenquark/repo-ansi/yanyao@openstack-deployment-liberty/playbooks/openstack-hosts-setup.yml,1,0,0,0,0,0,1
2019-03-09 02:16:38.742657, /home/brokenquark/repo-ansi/yanyao@openstack-deployment-liberty/playbooks/rabbitmq-install.yml,1,0,0,0,0,0,1
2019-03-09 02:16:38.756371, /home/brokenquark/repo-ansi/yanyao@openstack-deployment-liberty/playbooks/os-keystone-install.yml,1,0,0,0,0,0,1
2019-03-09 02:16:38.772174, /home/brokenquark/repo-ansi/yanyao@openstack-deployment-liberty/playbooks/os-glance-install.yml,1,0,0,0,0,0,1
2019-03-09 02:16:38.799526, /home/brokenquark/repo-ansi/yanyao@openstack-deployment-liberty/playbooks/os-nova-install.yml,1,0,0,0,0,0,1
2019-03-09 02:16:38.803333, /home/brokenquark/repo-ansi/yanyao@openstack-deployment-liberty/playbooks/os-swift-sync.yml,1,0,0,0,0,0,1
2019-03-09 02:16:38.833701, /home/brokenquark/repo-ansi/yanyao@openstack-deployment-liberty/playbooks/os-swift-setup.yml,2,0,0,0,0,0,2
2019-03-09 02:16:38.839741, /home/brokenquark/repo-ansi/yanyao@openstack-deployment-liberty/playbooks/os-tempest-install.yml,1,0,0,0,0,0,1
2019-03-09 02:16:38.848870, /home/brokenquark/repo-ansi/yanyao@openstack-deployment-liberty/playbooks/repo-build.yml,1,0,0,0,0,0,1
2019-03-09 02:16:38.864774, /home/brokenquark/repo-ansi/yanyao@openstack-deployment-liberty/playbooks/os-horizon-install.yml,1,0,0,0,0,0,1
2019-03-09 02:16:38.877368, /home/brokenquark/repo-ansi/yanyao@openstack-deployment-liberty/playbooks/os-ceilometer-install.yml,1,0,0,0,0,0,1
2019-03-09 02:16:38.894209, /home/brokenquark/repo-ansi/yanyao@openstack-deployment-liberty/playbooks/galera-install.yml,1,0,0,0,0,0,1
2019-03-09 02:16:38.916876, /home/brokenquark/repo-ansi/yanyao@openstack-deployment-liberty/playbooks/os-cinder-install.yml,1,0,0,0,0,0,1
2019-03-09 02:16:38.934258, /home/brokenquark/repo-ansi/yanyao@openstack-deployment-liberty/playbooks/utility-install.yml,3,0,0,0,0,0,3
2019-03-09 02:16:38.945358, /home/brokenquark/repo-ansi/yanyao@openstack-deployment-liberty/playbooks/rsyslog-install.yml,1,0,0,0,0,0,1
2019-03-09 02:16:38.965903, /home/brokenquark/repo-ansi/yanyao@openstack-deployment-liberty/playbooks/os-neutron-install.yml,1,0,0,0,0,0,1
2019-03-09 02:16:38.978723, /home/brokenquark/repo-ansi/yanyao@openstack-deployment-liberty/playbooks/os-heat-install.yml,1,0,0,0,0,0,1
2019-03-09 02:16:38.983374, /home/brokenquark/repo-ansi/yanyao@openstack-deployment-liberty/playbooks/lxc-containers-destroy.yml,1,0,0,0,0,0,1
2019-03-09 02:16:38.993499, /home/brokenquark/repo-ansi/yanyao@openstack-deployment-liberty/playbooks/os-aodh-install.yml,1,0,0,0,0,0,1
2019-03-09 02:16:39.007426, /home/brokenquark/repo-ansi/yanyao@openstack-deployment-liberty/playbooks/haproxy-install.yml,1,0,0,0,0,0,1
2019-03-09 02:16:39.011750, /home/brokenquark/repo-ansi/yanyao@openstack-deployment-liberty/playbooks/lxc-containers-create.yml,1,0,0,0,0,0,1
2019-03-09 02:16:39.015546, /home/brokenquark/repo-ansi/yanyao@openstack-deployment-liberty/playbooks/lxc-hosts-setup.yml,1,0,0,0,0,0,1
2019-03-09 02:16:39.025193, /home/brokenquark/repo-ansi/yanyao@openstack-deployment-liberty/playbooks/repo-server.yml,1,0,0,0,0,0,1
2019-03-09 02:16:39.061334, /home/brokenquark/repo-ansi/yanyao@openstack-deployment-liberty/playbooks/vars/configs/haproxy_config.yml,1,0,0,0,0,0,1
2019-03-09 02:16:39.082533, /home/brokenquark/repo-ansi/yanyao@openstack-deployment-liberty/playbooks/roles/system_crontab_coordination/tasks/main.yml,1,0,0,0,0,0,1
2019-03-09 02:16:39.104846, /home/brokenquark/repo-ansi/yanyao@openstack-deployment-liberty/playbooks/roles/os_swift/defaults/main.yml,5,0,0,0,0,0,5
2019-03-09 02:16:39.138755, /home/brokenquark/repo-ansi/yanyao@openstack-deployment-liberty/playbooks/roles/os_swift/tasks/swift_pre_install.yml,6,0,0,0,0,0,6
2019-03-09 02:16:39.193609, /home/brokenquark/repo-ansi/yanyao@openstack-deployment-liberty/playbooks/roles/os_swift/tasks/swift_upstart_common_init.yml,1,0,0,0,0,0,1
2019-03-09 02:16:39.210091, /home/brokenquark/repo-ansi/yanyao@openstack-deployment-liberty/playbooks/roles/os_swift/tasks/swift_storage_hosts_setup.yml,2,0,0,0,0,0,2
2019-03-09 02:16:39.248921, /home/brokenquark/repo-ansi/yanyao@openstack-deployment-liberty/playbooks/roles/memcached_server/defaults/main.yml,1,0,0,0,0,0,1
2019-03-09 02:16:39.254970, /home/brokenquark/repo-ansi/yanyao@openstack-deployment-liberty/playbooks/roles/memcached_server/tasks/memcached_config.yml,2,0,0,0,0,0,2
2019-03-09 02:16:39.274638, /home/brokenquark/repo-ansi/yanyao@openstack-deployment-liberty/playbooks/roles/os_aodh/defaults/main.yml,7,0,0,0,0,0,7
2019-03-09 02:16:39.310892, /home/brokenquark/repo-ansi/yanyao@openstack-deployment-liberty/playbooks/roles/os_aodh/tasks/aodh_upstart_common_init.yml,1,0,0,0,0,0,1
2019-03-09 02:16:39.363184, /home/brokenquark/repo-ansi/yanyao@openstack-deployment-liberty/playbooks/roles/os_glance/defaults/main.yml,7,0,0,2,0,0,9
2019-03-09 02:16:39.367612, /home/brokenquark/repo-ansi/yanyao@openstack-deployment-liberty/playbooks/roles/os_glance/tasks/glance_upstart_common_init.yml,1,0,0,0,0,0,1
2019-03-09 02:16:39.394732, /home/brokenquark/repo-ansi/yanyao@openstack-deployment-liberty/playbooks/roles/os_glance/tasks/glance_pre_install.yml,2,0,0,0,0,0,2
2019-03-09 02:16:39.435612, /home/brokenquark/repo-ansi/yanyao@openstack-deployment-liberty/playbooks/roles/os_glance/tasks/glance_post_install.yml,1,0,0,0,0,0,1
2019-03-09 02:16:39.454414, /home/brokenquark/repo-ansi/yanyao@openstack-deployment-liberty/playbooks/roles/galera_client/defaults/main.yml,3,0,0,0,0,0,3
2019-03-09 02:16:39.469972, /home/brokenquark/repo-ansi/yanyao@openstack-deployment-liberty/playbooks/roles/galera_client/tasks/galera_client_pre_install.yml,1,0,0,0,0,0,1
2019-03-09 02:16:39.474991, /home/brokenquark/repo-ansi/yanyao@openstack-deployment-liberty/playbooks/roles/galera_client/tasks/galera_client_post_install.yml,1,0,0,0,0,0,1
2019-03-09 02:16:39.483241, /home/brokenquark/repo-ansi/yanyao@openstack-deployment-liberty/playbooks/roles/os_swift_sync/defaults/main.yml,1,0,0,0,0,0,1
2019-03-09 02:16:39.500203, /home/brokenquark/repo-ansi/yanyao@openstack-deployment-liberty/playbooks/roles/os_swift_sync/tasks/swift_rings_distribute.yml,2,0,0,0,0,0,2
2019-03-09 02:16:39.574100, /home/brokenquark/repo-ansi/yanyao@openstack-deployment-liberty/playbooks/roles/os_nova/defaults/main.yml,12,0,0,0,0,0,12
2019-03-09 02:16:39.601463, /home/brokenquark/repo-ansi/yanyao@openstack-deployment-liberty/playbooks/roles/os_nova/tasks/nova_pre_install.yml,5,0,0,0,0,0,5
2019-03-09 02:16:39.712587, /home/brokenquark/repo-ansi/yanyao@openstack-deployment-liberty/playbooks/roles/os_nova/tasks/nova_upstart_common_init.yml,1,0,0,0,0,0,1
2019-03-09 02:16:39.731717, /home/brokenquark/repo-ansi/yanyao@openstack-deployment-liberty/playbooks/roles/os_horizon/defaults/main.yml,7,0,1,0,0,0,8
2019-03-09 02:16:39.769259, /home/brokenquark/repo-ansi/yanyao@openstack-deployment-liberty/playbooks/roles/os_horizon/tasks/horizon_apache.yml,1,0,0,0,0,0,1
2019-03-09 02:16:39.803458, /home/brokenquark/repo-ansi/yanyao@openstack-deployment-liberty/playbooks/roles/os_horizon/tasks/horizon_pre_install.yml,1,0,0,0,0,0,1
2019-03-09 02:16:39.823537, /home/brokenquark/repo-ansi/yanyao@openstack-deployment-liberty/playbooks/roles/os_horizon/tasks/horizon_ssl_user_provided.yml,2,0,0,0,0,0,2
2019-03-09 02:16:39.833688, /home/brokenquark/repo-ansi/yanyao@openstack-deployment-liberty/playbooks/roles/rabbitmq_server/defaults/main.yml,3,0,0,0,0,1,4
2019-03-09 02:16:39.845230, /home/brokenquark/repo-ansi/yanyao@openstack-deployment-liberty/playbooks/roles/rabbitmq_server/tasks/rabbitmq_post_install.yml,2,0,0,0,1,0,3
2019-03-09 02:16:39.853041, /home/brokenquark/repo-ansi/yanyao@openstack-deployment-liberty/playbooks/roles/rabbitmq_server/tasks/rabbitmq_ssl_key_distribute.yml,1,0,0,0,1,0,2
2019-03-09 02:16:39.861822, /home/brokenquark/repo-ansi/yanyao@openstack-deployment-liberty/playbooks/roles/rabbitmq_server/tasks/rabbitmq_ssl_user_provided.yml,2,0,0,0,0,0,2
2019-03-09 02:16:39.866661, /home/brokenquark/repo-ansi/yanyao@openstack-deployment-liberty/playbooks/roles/rabbitmq_server/tasks/rabbitmq_set_cookie.yml,1,0,0,0,0,0,1
2019-03-09 02:16:39.894019, /home/brokenquark/repo-ansi/yanyao@openstack-deployment-liberty/playbooks/roles/rabbitmq_server/tasks/rabbitmq_ssl_key_create.yml,1,0,0,0,0,0,1
2019-03-09 02:16:39.921805, /home/brokenquark/repo-ansi/yanyao@openstack-deployment-liberty/playbooks/roles/openstack_openrc/defaults/main.yml,1,0,0,0,0,0,1
2019-03-09 02:16:39.951919, /home/brokenquark/repo-ansi/yanyao@openstack-deployment-liberty/playbooks/roles/os_keystone/defaults/main.yml,9,0,0,1,0,0,10
2019-03-09 02:16:39.969370, /home/brokenquark/repo-ansi/yanyao@openstack-deployment-liberty/playbooks/roles/os_keystone/tasks/keystone_pre_install.yml,5,0,0,0,0,0,5
2019-03-09 02:16:39.985717, /home/brokenquark/repo-ansi/yanyao@openstack-deployment-liberty/playbooks/roles/os_keystone/tasks/keystone_ssl_user_provided.yml,2,0,0,0,0,0,2
2019-03-09 02:16:39.998607, /home/brokenquark/repo-ansi/yanyao@openstack-deployment-liberty/playbooks/roles/os_keystone/tasks/keystone_federation_sp_setup.yml,1,0,0,0,0,0,1
2019-03-09 02:16:40.026154, /home/brokenquark/repo-ansi/yanyao@openstack-deployment-liberty/playbooks/roles/os_keystone/tasks/keystone_apache.yml,1,0,0,0,0,0,1
2019-03-09 02:16:40.149163, /home/brokenquark/repo-ansi/yanyao@openstack-deployment-liberty/playbooks/roles/os_keystone/tasks/keystone_fernet_keys_autorotate.yml,1,0,0,0,0,0,1
2019-03-09 02:16:40.167040, /home/brokenquark/repo-ansi/yanyao@openstack-deployment-liberty/playbooks/roles/haproxy_server/defaults/main.yml,7,0,1,0,0,0,8
2019-03-09 02:16:40.179571, /home/brokenquark/repo-ansi/yanyao@openstack-deployment-liberty/playbooks/roles/haproxy_server/tasks/haproxy_add_ppa_repo.yml,1,0,0,0,0,0,1
2019-03-09 02:16:40.196383, /home/brokenquark/repo-ansi/yanyao@openstack-deployment-liberty/playbooks/roles/haproxy_server/tasks/haproxy_ssl_configuration.yml,2,0,0,0,0,0,2
2019-03-09 02:16:40.222680, /home/brokenquark/repo-ansi/yanyao@openstack-deployment-liberty/playbooks/roles/repo_build/defaults/main.yml,1,0,0,0,0,0,1
2019-03-09 02:16:40.296540, /home/brokenquark/repo-ansi/yanyao@openstack-deployment-liberty/playbooks/roles/os_heat/defaults/main.yml,12,0,0,0,0,0,12
2019-03-09 02:16:40.304381, /home/brokenquark/repo-ansi/yanyao@openstack-deployment-liberty/playbooks/roles/os_heat/tasks/heat_upstart_common_init.yml,1,0,0,0,0,0,1
2019-03-09 02:16:40.352594, /home/brokenquark/repo-ansi/yanyao@openstack-deployment-liberty/playbooks/roles/os_heat/tasks/heat_pre_install.yml,2,0,0,0,0,0,2
2019-03-09 02:16:40.401451, /home/brokenquark/repo-ansi/yanyao@openstack-deployment-liberty/playbooks/roles/ceph_client/defaults/main.yml,3,0,0,0,0,0,3
2019-03-09 02:16:40.410884, /home/brokenquark/repo-ansi/yanyao@openstack-deployment-liberty/playbooks/roles/ceph_client/tasks/ceph_config.yml,2,0,0,0,0,0,2
2019-03-09 02:16:40.436101, /home/brokenquark/repo-ansi/yanyao@openstack-deployment-liberty/playbooks/roles/ceph_client/tasks/ceph_auth.yml,1,0,0,0,0,0,1
2019-03-09 02:16:40.463156, /home/brokenquark/repo-ansi/yanyao@openstack-deployment-liberty/playbooks/roles/galera_server/defaults/main.yml,5,1,0,0,1,0,7
2019-03-09 02:16:40.473086, /home/brokenquark/repo-ansi/yanyao@openstack-deployment-liberty/playbooks/roles/galera_server/tasks/galera_post_install.yml,4,0,0,0,0,0,4
2019-03-09 02:16:40.515987, /home/brokenquark/repo-ansi/yanyao@openstack-deployment-liberty/playbooks/roles/galera_server/tasks/galera_pre_install.yml,1,0,0,0,0,0,1
2019-03-09 02:16:40.532691, /home/brokenquark/repo-ansi/yanyao@openstack-deployment-liberty/playbooks/roles/os_ceilometer/defaults/main.yml,7,0,0,0,0,0,7
2019-03-09 02:16:40.558646, /home/brokenquark/repo-ansi/yanyao@openstack-deployment-liberty/playbooks/roles/os_ceilometer/tasks/ceilometer_pre_install.yml,1,0,0,0,0,0,1
2019-03-09 02:16:40.565228, /home/brokenquark/repo-ansi/yanyao@openstack-deployment-liberty/playbooks/roles/os_ceilometer/tasks/ceilometer_upstart_common_init.yml,1,0,0,0,0,0,1
2019-03-09 02:16:40.641366, /home/brokenquark/repo-ansi/yanyao@openstack-deployment-liberty/playbooks/roles/os_neutron/defaults/main.yml,7,0,0,0,0,0,7
2019-03-09 02:16:40.687962, /home/brokenquark/repo-ansi/yanyao@openstack-deployment-liberty/playbooks/roles/os_neutron/tasks/neutron_upstart_common_init.yml,1,0,0,0,0,0,1
2019-03-09 02:16:40.713251, /home/brokenquark/repo-ansi/yanyao@openstack-deployment-liberty/playbooks/roles/os_neutron/tasks/neutron_post_install.yml,1,0,0,0,0,0,1
2019-03-09 02:16:40.764920, /home/brokenquark/repo-ansi/yanyao@openstack-deployment-liberty/playbooks/roles/os_neutron/tasks/neutron_l3_ha.yml,3,0,0,0,0,0,3
2019-03-09 02:16:40.783844, /home/brokenquark/repo-ansi/yanyao@openstack-deployment-liberty/playbooks/roles/os_neutron/tasks/neutron_pre_install.yml,3,0,0,0,0,0,3
2019-03-09 02:16:40.812674, /home/brokenquark/repo-ansi/yanyao@openstack-deployment-liberty/playbooks/roles/rsyslog_server/tasks/rsyslog_server_post_install.yml,2,0,0,0,0,0,2
2019-03-09 02:16:40.815589, /home/brokenquark/repo-ansi/yanyao@openstack-deployment-liberty/playbooks/roles/rsyslog_server/tasks/rsyslog_server_pre_install.yml,1,0,0,0,0,0,1
2019-03-09 02:16:40.834299, /home/brokenquark/repo-ansi/yanyao@openstack-deployment-liberty/playbooks/roles/os_tempest/defaults/main.yml,6,0,1,0,0,0,7
2019-03-09 02:16:40.886993, /home/brokenquark/repo-ansi/yanyao@openstack-deployment-liberty/playbooks/roles/os_tempest/tasks/tempest_post_install.yml,3,0,0,0,0,0,3
2019-03-09 02:16:40.937585, /home/brokenquark/repo-ansi/yanyao@openstack-deployment-liberty/playbooks/roles/repo_server/defaults/main.yml,1,0,0,0,0,0,1
2019-03-09 02:16:40.963290, /home/brokenquark/repo-ansi/yanyao@openstack-deployment-liberty/playbooks/roles/repo_server/tasks/repo_pre_install.yml,1,0,0,0,0,0,1
2019-03-09 02:16:40.992194, /home/brokenquark/repo-ansi/yanyao@openstack-deployment-liberty/playbooks/roles/repo_server/tasks/repo_post_install.yml,2,0,0,0,0,0,2
2019-03-09 02:16:41.048278, /home/brokenquark/repo-ansi/yanyao@openstack-deployment-liberty/playbooks/roles/os_cinder/defaults/main.yml,9,0,0,0,0,0,9
2019-03-09 02:16:41.066879, /home/brokenquark/repo-ansi/yanyao@openstack-deployment-liberty/playbooks/roles/os_cinder/tasks/cinder_pre_install.yml,3,0,0,0,0,0,3
2019-03-09 02:16:41.072136, /home/brokenquark/repo-ansi/yanyao@openstack-deployment-liberty/playbooks/roles/os_cinder/tasks/cinder_lvm_config.yml,1,0,0,0,0,0,1
2019-03-09 02:16:41.084866, /home/brokenquark/repo-ansi/yanyao@openstack-deployment-liberty/playbooks/roles/os_cinder/tasks/cinder_upstart_common_init.yml,1,0,0,0,0,0,1
2019-03-09 02:16:41.216999, /home/brokenquark/repo-ansi/yanyao@openstack-deployment-liberty/playbooks/inventory/group_vars/all_containers.yml,17,0,0,0,0,0,17
2019-03-09 02:16:41.243852, /home/brokenquark/repo-ansi/yanyao@openstack-deployment-liberty/playbooks/inventory/group_vars/hosts.yml,17,0,0,0,0,0,17
2019-03-08 12:54:53.478405,Users/akond/SECU_REPOS/ostk/ansi/bifrost/playbooks/roles/bifrost/configdrives/dynamic/defaults/main.yml,1,0,0,0,0,0,1
2019-03-08 12:54:53.478463,Users/akond/SECU_REPOS/ostk/ansi/bifrost/playbooks/roles/bifrost/openstack/ci/prep/defaults/main.yml,1,0,0,0,0,0,1
2019-03-08 12:54:53.478468,Users/akond/SECU_REPOS/ostk/ansi/bifrost/playbooks/roles/bifrost/openstack/ci/prep/tasks/main.yml,2,0,0,0,0,0,2
2019-03-08 12:54:53.478473,Users/akond/SECU_REPOS/ostk/ansi/bifrost/playbooks/roles/bifrost/prep/for/install/defaults/main.yml,1,0,0,0,0,0,1
2019-03-08 12:54:53.478484,Users/akond/SECU_REPOS/ostk/ansi/bifrost/playbooks/roles/bifrost/keystone/install/defaults/required_defaults_RedHat_family.yml,1,0,0,0,0,0,1
2019-03-08 12:54:53.478500,Users/akond/SECU_REPOS/ostk/ansi/bifrost/playbooks/roles/bifrost/keystone/install/tasks/bootstrap.yml,9,0,0,0,1,0,10
2019-03-08 12:54:53.478503,Users/akond/SECU_REPOS/ostk/ansi/bifrost/playbooks/roles/bifrost/create/vm/nodes/tasks/prepare_libvirt.yml,0,0,0,0,1,0,1
2019-03-08 12:54:53.478525,Users/akond/SECU_REPOS/ostk/ansi/bifrost/playbooks/roles/bifrost/deploy/nodes/dynamic/tasks/main.yml,2,0,0,0,0,0,2
2019-03-08 12:54:53.478550,Users/akond/SECU_REPOS/ostk/ansi/bifrost/playbooks/roles/bifrost/create/vm/nodes/tasks/create_vm.yml,2,0,0,0,0,0,2
2019-03-08 12:54:53.478570,Users/akond/SECU_REPOS/ostk/ansi/bifrost/playbooks/roles/bifrost/keystone/install/defaults/main.yml,7,1,0,0,0,0,8
2019-03-08 12:54:53.478573,Users/akond/SECU_REPOS/ostk/ansi/bifrost/playbooks/roles/bifrost/keystone/install/defaults/required_defaults_Debian_family.yml,1,0,0,0,0,0,1
2019-03-08 12:54:53.478580,Users/akond/SECU_REPOS/ostk/ansi/bifrost/playbooks/roles/bifrost/ironic/install/tasks/ironic_config.yml,1,0,0,0,0,0,1
2019-03-08 12:54:53.478586,Users/akond/SECU_REPOS/ostk/ansi/bifrost/playbooks/roles/bifrost/ironic/install/tasks/keystone_setup.yml,20,0,0,0,0,0,20
2019-03-08 12:54:53.478590,Users/akond/SECU_REPOS/ostk/ansi/bifrost/playbooks/roles/bifrost/ironic/install/tasks/keystone_setup_inspector.yml,12,0,0,0,0,0,12
2019-03-08 12:54:53.478600,Users/akond/SECU_REPOS/ostk/ansi/bifrost/playbooks/roles/bifrost/create/vm/nodes/tasks/main.yml,0,0,0,0,2,0,2
2019-03-08 12:54:53.478605,Users/akond/SECU_REPOS/ostk/ansi/bifrost/playbooks/roles/bifrost/ironic/install/defaults/main.yml,12,1,0,0,3,0,16
2019-03-08 12:54:53.478608,Users/akond/SECU_REPOS/ostk/ansi/bifrost/playbooks/roles/bifrost/ironic/install/defaults/required_defaults_RedHat_family.yml,1,0,0,0,0,0,1
2019-03-08 12:54:53.478615,Users/akond/SECU_REPOS/ostk/ansi/bifrost/playbooks/roles/bifrost/ironic/install/defaults/required_defaults_Suse_family.yml,1,0,0,0,0,0,1
2019-03-08 12:54:53.478639,Users/akond/SECU_REPOS/ostk/ansi/bifrost/playbooks/roles/bifrost/ironic/install/tasks/bootstrap.yml,12,0,0,0,0,0,12
2019-03-08 12:54:53.478642,Users/akond/SECU_REPOS/ostk/ansi/bifrost/playbooks/roles/bifrost/ironic/install/tasks/create_tftpboot.yml,1,0,0,0,0,0,1
2019-03-08 12:54:53.478650,Users/akond/SECU_REPOS/ostk/ansi/bifrost/playbooks/roles/bifrost/ironic/install/tasks/inspector_bootstrap.yml,2,0,0,0,0,0,2
2019-03-08 12:54:53.478706,Users/akond/SECU_REPOS/ostk/ansi/bifrost/playbooks/roles/ironic/inspect/node/tasks/main.yml,2,0,0,0,1,0,3
2019-03-08 12:54:53.478784,Users/akond/SECU_REPOS/ostk/ansi/bifrost/playbooks/roles/bifrost/keystone/install/tasks/install.yml,0,0,0,0,1,0,1
2019-03-08 12:54:53.479082,Users/akond/SECU_REPOS/ostk/ansi/bifrost/playbooks/roles/bifrost/keystone/install/defaults/required_defaults_Debian_jessie.yml,1,0,0,0,0,0,1
2019-03-08 12:54:53.479110,Users/akond/SECU_REPOS/ostk/ansi/openstack/ansible/playbooks/etcd/install.yml,1,0,0,0,0,0,1
2019-03-08 12:54:53.479374,Users/akond/SECU_REPOS/ostk/ansi/networking/ovn/migration/tripleo_environment/playbooks/roles/backup/tasks/main.yml,0,0,0,0,1,0,1
2019-03-08 12:54:53.479405,Users/akond/SECU_REPOS/ostk/ansi/networking/ovn/migration/tripleo_environment/playbooks/roles/resources/validate/defaults/main.yml,1,0,0,0,0,0,1
2019-03-08 12:54:53.479473,Users/akond/SECU_REPOS/ostk/ansi/openstack/ansible/zuul.d/playbooks/post.yml,2,0,0,0,0,1,3
2019-03-08 12:54:53.479491,Users/akond/SECU_REPOS/ostk/ansi/openstack/ansible/playbooks/repo/server.yml,1,0,0,0,0,0,1
2019-03-08 12:54:53.479510,Users/akond/SECU_REPOS/ostk/ansi/openstack/ansible/playbooks/roles/system_crontab_coordination/tasks/main.yml,1,0,0,0,0,0,1
2019-03-08 12:54:53.479512,Users/akond/SECU_REPOS/ostk/ansi/openstack/ansible/playbooks/rsyslog/install.yml,1,0,0,0,0,0,1
2019-03-08 12:54:53.479515,Users/akond/SECU_REPOS/ostk/ansi/openstack/ansible/playbooks/security/hardening.yml,1,0,0,0,0,0,1
2019-03-08 12:54:53.479529,Users/akond/SECU_REPOS/ostk/ansi/networking/ovn/playbooks/legacy/tempest/post/common.yml,0,0,0,0,1,0,1
2019-03-08 12:54:53.479539,Users/akond/SECU_REPOS/ostk/ansi/openstack/ansible/playbooks/os/cinder/install.yml,4,0,0,0,0,0,4
2019-03-08 12:54:53.479541,Users/akond/SECU_REPOS/ostk/ansi/openstack/ansible/playbooks/os/congress/install.yml,1,0,0,0,0,0,1
2019-03-08 12:54:53.479544,Users/akond/SECU_REPOS/ostk/ansi/openstack/ansible/playbooks/os/designate/install.yml,1,0,0,0,0,0,1
2019-03-08 12:54:53.479546,Users/akond/SECU_REPOS/ostk/ansi/openstack/ansible/playbooks/os/glance/install.yml,2,0,0,0,0,0,2
2019-03-08 12:54:53.479549,Users/akond/SECU_REPOS/ostk/ansi/openstack/ansible/playbooks/os/gnocchi/install.yml,1,0,0,0,0,0,1
2019-03-08 12:54:53.479551,Users/akond/SECU_REPOS/ostk/ansi/openstack/ansible/playbooks/os/heat/install.yml,1,0,0,0,0,0,1
2019-03-08 12:54:53.479554,Users/akond/SECU_REPOS/ostk/ansi/openstack/ansible/playbooks/os/horizon/install.yml,1,0,0,0,0,0,1
2019-03-08 12:54:53.479556,Users/akond/SECU_REPOS/ostk/ansi/openstack/ansible/playbooks/os/ironic/install.yml,1,0,0,0,0,0,1
2019-03-08 12:54:53.479559,Users/akond/SECU_REPOS/ostk/ansi/openstack/ansible/playbooks/os/keystone/install.yml,2,0,0,0,0,0,2
2019-03-08 12:54:53.479561,Users/akond/SECU_REPOS/ostk/ansi/openstack/ansible/playbooks/os/magnum/install.yml,1,0,0,0,0,0,1
2019-03-08 12:54:53.479567,Users/akond/SECU_REPOS/ostk/ansi/openstack/ansible/playbooks/os/nova/install.yml,4,0,0,0,0,0,4
2019-03-08 12:54:53.479569,Users/akond/SECU_REPOS/ostk/ansi/openstack/ansible/playbooks/os/octavia/install.yml,1,0,0,0,0,0,1
2019-03-08 12:54:53.479572,Users/akond/SECU_REPOS/ostk/ansi/openstack/ansible/playbooks/os/rally/install.yml,1,0,0,0,0,0,1
2019-03-08 12:54:53.479574,Users/akond/SECU_REPOS/ostk/ansi/openstack/ansible/playbooks/galera/install.yml,2,0,0,0,0,0,2
2019-03-08 12:54:53.479577,Users/akond/SECU_REPOS/ostk/ansi/openstack/ansible/playbooks/haproxy/install.yml,1,0,0,0,0,0,1
2019-03-08 12:54:53.479582,Users/akond/SECU_REPOS/ostk/ansi/openstack/ansible/playbooks/healthcheck/infrastructure.yml,4,0,0,0,0,0,4
2019-03-08 12:54:53.479587,Users/akond/SECU_REPOS/ostk/ansi/openstack/ansible/playbooks/infra/journal/remote.yml,4,0,0,0,0,0,4
2019-03-08 12:54:53.479592,Users/akond/SECU_REPOS/ostk/ansi/openstack/ansible/playbooks/lxc/containers/create.yml,3,0,0,0,0,0,3
2019-03-08 12:54:53.479595,Users/akond/SECU_REPOS/ostk/ansi/openstack/ansible/playbooks/lxc/containers/destroy.yml,2,0,0,0,0,0,2
2019-03-08 12:54:53.479598,Users/akond/SECU_REPOS/ostk/ansi/openstack/ansible/playbooks/lxc/hosts/setup.yml,1,0,0,0,0,0,1
2019-03-08 12:54:53.479600,Users/akond/SECU_REPOS/ostk/ansi/openstack/ansible/playbooks/memcached/install.yml,1,0,0,0,0,0,1
2019-03-08 12:54:53.479603,Users/akond/SECU_REPOS/ostk/ansi/openstack/ansible/playbooks/openstack/hosts/setup.yml,2,0,0,0,0,0,2
2019-03-08 12:54:53.479605,Users/akond/SECU_REPOS/ostk/ansi/openstack/ansible/playbooks/os/aodh/install.yml,1,0,0,0,0,0,1
2019-03-08 12:54:53.479617,Users/akond/SECU_REPOS/ostk/ansi/openstack/ansible/playbooks/os/barbican/install.yml,1,0,0,0,0,0,1
2019-03-08 12:54:53.479620,Users/akond/SECU_REPOS/ostk/ansi/openstack/ansible/playbooks/os/blazar/install.yml,1,0,0,0,0,0,1
2019-03-08 12:54:53.479623,Users/akond/SECU_REPOS/ostk/ansi/openstack/ansible/playbooks/os/swift/install.yml,2,0,0,0,0,0,2
2019-03-08 12:54:53.479626,Users/akond/SECU_REPOS/ostk/ansi/openstack/ansible/playbooks/os/swift/sync.yml,1,0,0,0,0,0,1
2019-03-08 12:54:53.479628,Users/akond/SECU_REPOS/ostk/ansi/openstack/ansible/playbooks/os/tacker/install.yml,1,0,0,0,0,0,1
2019-03-08 12:54:53.479631,Users/akond/SECU_REPOS/ostk/ansi/openstack/ansible/playbooks/os/tempest/install.yml,1,0,0,0,0,0,1
2019-03-08 12:54:53.479633,Users/akond/SECU_REPOS/ostk/ansi/openstack/ansible/playbooks/os/trove/install.yml,1,0,0,0,0,0,1
2019-03-08 12:54:53.479636,Users/akond/SECU_REPOS/ostk/ansi/openstack/ansible/playbooks/rabbitmq/install.yml,4,0,0,0,0,0,4
2019-03-08 12:54:53.479639,Users/akond/SECU_REPOS/ostk/ansi/openstack/ansible/playbooks/repo/build.yml,1,0,0,0,0,0,1
2019-03-08 12:54:53.479644,Users/akond/SECU_REPOS/ostk/ansi/openstack/ansible/playbooks/common/tasks/unbound/clients.yml,0,0,0,0,1,0,1
2019-03-08 12:54:53.479648,Users/akond/SECU_REPOS/ostk/ansi/openstack/ansible/playbooks/containers/lxc/create.yml,3,0,0,0,0,0,3
2019-03-08 12:54:53.479651,Users/akond/SECU_REPOS/ostk/ansi/openstack/ansible/playbooks/containers/lxc/destroy.yml,2,0,0,0,0,0,2
2019-03-08 12:54:53.479653,Users/akond/SECU_REPOS/ostk/ansi/openstack/ansible/playbooks/containers/lxc/host.yml,1,0,0,0,0,0,1
2019-03-08 12:54:53.479656,Users/akond/SECU_REPOS/ostk/ansi/openstack/ansible/playbooks/containers/nspawn/create.yml,3,0,0,0,0,0,3
2019-03-08 12:54:53.479659,Users/akond/SECU_REPOS/ostk/ansi/openstack/ansible/playbooks/containers/nspawn/destroy.yml,2,0,0,0,0,0,2
2019-03-08 12:54:53.479664,Users/akond/SECU_REPOS/ostk/ansi/openstack/ansible/playbooks/unbound/install.yml,2,0,0,0,0,0,2
2019-03-08 12:54:53.479667,Users/akond/SECU_REPOS/ostk/ansi/openstack/ansible/playbooks/utility/install.yml,3,0,0,0,0,0,3
2019-03-08 12:54:53.479694,Users/akond/SECU_REPOS/ostk/ansi/openstack/ansible/playbooks/common/tasks/os/lxc/container/setup.yml,0,0,0,0,4,0,4
2019-03-08 12:54:53.479703,Users/akond/SECU_REPOS/ostk/ansi/openstack/ansible/playbooks/common/tasks/restart/service.yml,0,0,0,0,1,0,1
2019-03-08 12:54:53.479706,Users/akond/SECU_REPOS/ostk/ansi/openstack/ansible/playbooks/ceph/rgw/install.yml,1,0,0,0,0,0,1
2019-03-08 12:54:53.479709,Users/akond/SECU_REPOS/ostk/ansi/openstack/ansible/playbooks/ceph/rgw/keystone/setup.yml,1,0,0,0,0,0,1
2019-03-08 12:54:53.479711,Users/akond/SECU_REPOS/ostk/ansi/openstack/ansible/playbooks/common/playbooks/cinder.yml,1,0,0,0,0,0,1
2019-03-08 12:54:53.479713,Users/akond/SECU_REPOS/ostk/ansi/openstack/ansible/playbooks/common/playbooks/glance.yml,1,0,0,0,0,0,1
2019-03-08 12:54:53.479716,Users/akond/SECU_REPOS/ostk/ansi/openstack/ansible/playbooks/common/playbooks/neutron.yml,1,0,0,0,0,0,1
2019-03-08 12:54:53.479727,Users/akond/SECU_REPOS/ostk/ansi/openstack/ansible/playbooks/common/playbooks/nova.yml,1,0,0,0,0,0,1
2019-03-08 12:54:53.479755,Users/akond/SECU_REPOS/ostk/ansi/openstack/ansible/playbooks/os/ceilometer/install.yml,1,0,0,0,0,0,1
2019-03-08 12:54:53.479758,Users/akond/SECU_REPOS/ostk/ansi/openstack/ansible/playbooks/os/sahara/install.yml,1,0,0,0,0,0,1
2019-03-08 12:54:53.479767,Users/akond/SECU_REPOS/ostk/ansi/openstack/ansible/scripts/upgrade/utilities/playbooks/galera/cluster/rolling/restart.yml,1,0,0,0,0,0,1
2019-03-08 12:54:53.479985,Users/akond/SECU_REPOS/ostk/ansi/openstack/ansible/scripts/upgrade/utilities/playbooks/memcached/flush.yml,1,0,0,0,0,0,1
2019-03-08 12:54:53.479987,Users/akond/SECU_REPOS/ostk/ansi/openstack/ansible/scripts/upgrade/utilities/playbooks/pip/conf/removal.yml,1,0,0,0,0,0,1
2019-03-08 12:54:53.479990,Users/akond/SECU_REPOS/ostk/ansi/openstack/ansible/scripts/upgrade/utilities/playbooks/user/secrets/adjustment.yml,1,0,0,0,0,0,1
2019-03-08 12:54:53.480020,Users/akond/SECU_REPOS/ostk/ansi/openstack/ansible/scripts/upgrade/utilities/playbooks/ansible_fact_cleanup.yml,1,0,0,0,0,0,1
2019-03-08 12:54:53.480022,Users/akond/SECU_REPOS/ostk/ansi/openstack/ansible/scripts/upgrade/utilities/playbooks/ceph/galaxy/removal.yml,1,0,0,0,0,0,1
2019-03-08 12:54:53.480025,Users/akond/SECU_REPOS/ostk/ansi/openstack/ansible/scripts/upgrade/utilities/playbooks/deploy/config/changes.yml,4,0,0,0,0,0,4
2019-03-08 12:54:53.480027,Users/akond/SECU_REPOS/ostk/ansi/openstack/ansible/ops/ansible_tools/playbooks/archive/containers.yml,1,0,0,0,0,0,1
2019-03-08 12:54:53.480032,Users/akond/SECU_REPOS/ostk/ansi/openstack/ansible/ops/ansible_tools/playbooks/remove_compute_node.yml,1,0,0,0,0,0,1
2019-03-08 12:54:53.480043,Users/akond/SECU_REPOS/ostk/ansi/openstack/ansible/ops/ansible_tools/playbooks/swift_storage_mount_drives.yml,3,0,0,0,0,0,3
2019-03-08 12:54:53.480076,Users/akond/SECU_REPOS/ostk/ansi/openstack/ansible/ops/multi/node/aio/playbooks/setup/host.yml,9,0,0,0,0,0,9
2019-03-08 12:54:53.480126,Users/akond/SECU_REPOS/ostk/ansi/openstack/ansible/ops/multi/node/aio/playbooks/test/host.yml,2,0,0,0,0,0,2
2019-03-08 12:54:53.480129,Users/akond/SECU_REPOS/ostk/ansi/openstack/ansible/ops/multi/node/aio/playbooks/vars/openstack/service/config.yml,1,0,8,0,0,0,9
2019-03-08 12:54:53.480173,Users/akond/SECU_REPOS/ostk/ansi/openstack/ansible/ops/pxelinux/provisioning/playbooks/deploy/dhcp.yml,2,0,0,0,0,0,2
2019-03-08 12:54:53.480190,Users/akond/SECU_REPOS/ostk/ansi/openstack/ansible/ops/multi/node/aio/playbooks/openstack/service/setup.yml,1,0,0,0,0,0,1
2019-03-08 12:54:53.480203,Users/akond/SECU_REPOS/ostk/ansi/openstack/ansible/ops/pxelinux/provisioning/playbooks/deploy/pxe.yml,12,0,0,0,0,0,12
2019-03-08 12:54:53.480206,Users/akond/SECU_REPOS/ostk/ansi/openstack/ansible/playbooks/ceph/install.yml,3,0,2,0,0,0,5
2019-03-08 12:54:53.480213,Users/akond/SECU_REPOS/ostk/ansi/openstack/ansible/playbooks/containers/nspawn/host.yml,1,0,0,0,0,0,1
2019-03-08 12:54:53.480217,Users/akond/SECU_REPOS/ostk/ansi/openstack/ansible/ops/pxelinux/provisioning/playbooks/group_vars/all.yml,1,0,2,1,0,3,7
2019-03-08 12:54:53.480222,Users/akond/SECU_REPOS/ostk/ansi/openstack/ansible/ops/pxelinux/provisioning/playbooks/inventory.yml,1,0,0,0,0,0,1
2019-03-08 12:54:53.480226,Users/akond/SECU_REPOS/ostk/ansi/openstack/ansible/ops/pxelinux/provisioning/playbooks/setup/host.yml,7,0,0,0,0,0,7
2019-03-08 12:54:53.480234,Users/akond/SECU_REPOS/ostk/ansi/openstack/ansible/ops/multi/node/aio/playbooks/deploy/osa.yml,7,0,0,0,0,0,7
2019-03-08 12:54:53.480238,Users/akond/SECU_REPOS/ostk/ansi/openstack/ansible/ops/multi/node/aio/playbooks/deploy/pxe.yml,13,0,0,0,0,0,13
2019-03-08 12:54:53.480242,Users/akond/SECU_REPOS/ostk/ansi/openstack/ansible/ops/multi/node/aio/playbooks/deploy/vms.yml,5,0,0,0,0,0,5
2019-03-08 12:54:53.480248,Users/akond/SECU_REPOS/ostk/ansi/openstack/ansible/ops/multi/node/aio/playbooks/group_vars/all.yml,0,0,10,1,0,0,11
2019-03-08 12:54:53.480493,Users/akond/SECU_REPOS/ostk/ansi/openstack/ansible/ops/leap/upgrades/upgrade/utilities/kilo/playbooks/container/network/adjustments.yml,1,0,0,0,0,0,1
2019-03-08 12:54:53.480496,Users/akond/SECU_REPOS/ostk/ansi/openstack/ansible/ops/leap/upgrades/upgrade/utilities/kilo/playbooks/container/network/bounce.yml,1,0,0,0,0,0,1
2019-03-08 12:54:53.480498,Users/akond/SECU_REPOS/ostk/ansi/openstack/ansible/ops/leap/upgrades/upgrade/utilities/kilo/playbooks/host/adjustments.yml,1,0,0,0,0,0,1
2019-03-08 12:54:53.480584,Users/akond/SECU_REPOS/ostk/ansi/openstack/ansible/ops/leap/upgrades/upgrade/utilities/kilo/playbooks/swift/repo/adjustments.yml,1,0,0,0,0,0,1
2019-03-08 12:54:53.480586,Users/akond/SECU_REPOS/ostk/ansi/openstack/ansible/ops/leap/upgrades/upgrade/utilities/kilo/playbooks/swift/ring/adjustments.yml,2,0,0,0,0,0,2
2019-03-08 12:54:53.480589,Users/akond/SECU_REPOS/ostk/ansi/openstack/ansible/ops/leap/upgrades/upgrade/utilities/kilo/playbooks/user/secrets/adjustments/kilo.yml,1,0,0,0,0,0,1
2019-03-08 12:54:53.480591,Users/akond/SECU_REPOS/ostk/ansi/openstack/ansible/ops/leap/upgrades/upgrade/utilities/liberty/playbooks/ansible_fact_cleanup/liberty.yml,1,0,0,0,0,0,1
2019-03-08 12:54:53.480594,Users/akond/SECU_REPOS/ostk/ansi/openstack/ansible/ops/leap/upgrades/upgrade/utilities/liberty/playbooks/deploy/config/changes/liberty.yml,1,0,0,0,0,0,1
2019-03-08 12:54:53.480596,Users/akond/SECU_REPOS/ostk/ansi/openstack/ansible/ops/leap/upgrades/upgrade/utilities/liberty/playbooks/mariadb/apt/cleanup.yml,1,0,0,0,0,0,1
2019-03-08 12:54:53.480599,Users/akond/SECU_REPOS/ostk/ansi/openstack/ansible/ops/leap/upgrades/upgrade/utilities/liberty/playbooks/memcached/flush.yml,1,0,0,0,0,0,1
2019-03-08 12:54:53.480601,Users/akond/SECU_REPOS/ostk/ansi/openstack/ansible/ops/leap/upgrades/upgrade/utilities/liberty/playbooks/user/secrets/adjustment/liberty.yml,1,0,0,0,0,0,1
2019-03-08 12:54:53.480603,Users/akond/SECU_REPOS/ostk/ansi/openstack/ansible/ops/leap/upgrades/upgrade/utilities/mitaka/playbooks/ansible_fact_cleanup/mitaka/1.yml,1,0,0,0,0,0,1
2019-03-08 12:54:53.480606,Users/akond/SECU_REPOS/ostk/ansi/openstack/ansible/ops/leap/upgrades/upgrade/utilities/mitaka/playbooks/ansible_fact_cleanup/mitaka/2.yml,1,0,0,0,0,0,1
2019-03-08 12:54:53.480608,Users/akond/SECU_REPOS/ostk/ansi/openstack/ansible/ops/leap/upgrades/upgrade/utilities/mitaka/playbooks/deploy/config/changes/mitaka.yml,1,0,0,0,0,0,1
2019-03-08 12:54:53.480611,Users/akond/SECU_REPOS/ostk/ansi/openstack/ansible/ops/leap/upgrades/upgrade/utilities/mitaka/playbooks/old/hostname/compatibility/mitaka.yml,1,0,0,0,0,0,1
2019-03-08 12:54:53.480614,Users/akond/SECU_REPOS/ostk/ansi/openstack/ansible/ops/leap/upgrades/upgrade/utilities/mitaka/playbooks/pip/conf/removal.yml,1,0,0,0,0,0,1
2019-03-08 12:54:53.480616,Users/akond/SECU_REPOS/ostk/ansi/openstack/ansible/ops/leap/upgrades/upgrade/utilities/newton/playbooks/memcached/flush.yml,1,0,0,0,0,0,1
2019-03-08 12:54:53.480621,Users/akond/SECU_REPOS/ostk/ansi/openstack/ansible/ops/leap/upgrades/upgrade/utilities/newton/playbooks/user/secrets/adjustment/newton.yml,1,0,0,0,0,0,1
2019-03-08 12:54:53.480624,Users/akond/SECU_REPOS/ostk/ansi/openstack/ansible/ops/multi/node/aio/playbooks/deploy/acng.yml,2,0,1,0,0,0,3
2019-03-08 12:54:53.480627,Users/akond/SECU_REPOS/ostk/ansi/openstack/ansible/ops/multi/node/aio/playbooks/deploy/dhcp.yml,2,0,0,0,0,0,2
2019-03-08 12:54:53.480629,Users/akond/SECU_REPOS/ostk/ansi/openstack/ansible/ops/leap/upgrades/upgrade/utilities/kilo/playbooks/remove/juno/log/rotate.yml,1,0,0,0,0,0,1
2019-03-08 12:54:53.480632,Users/akond/SECU_REPOS/ostk/ansi/openstack/ansible/ops/leap/upgrades/upgrade/utilities/liberty/playbooks/disable/neutron/port/security.yml,1,0,0,0,0,0,1
2019-03-08 12:54:53.480634,Users/akond/SECU_REPOS/ostk/ansi/openstack/ansible/ops/leap/upgrades/upgrade/utilities/mitaka/playbooks/user/secrets/adjustment/mitaka.yml,1,0,0,0,0,0,1
2019-03-08 12:54:53.480836,Users/akond/SECU_REPOS/ostk/ansi/openstack/ansible/zuul.d/playbooks/run.yml,1,0,0,0,0,0,1
2019-03-08 12:54:53.480921,Users/akond/SECU_REPOS/ostk/ansi/tripleo/quickstart/playbooks/quickstart.yml,1,0,0,0,0,0,1
2019-03-08 12:54:53.480990,Users/akond/SECU_REPOS/ostk/ansi/windmill/playbooks/nodepool.yaml,2,0,0,0,0,0,2
2019-03-08 12:54:53.480997,Users/akond/SECU_REPOS/ostk/ansi/windmill/playbooks/roles/test.nodepool/builder/tasks/main.yaml,1,0,0,0,0,0,1
2019-03-08 12:54:53.480999,Users/akond/SECU_REPOS/ostk/ansi/windmill/playbooks/roles/test.nodepool/launcher/tasks/main.yaml,1,0,0,0,0,0,1
2019-03-08 12:54:53.481002,Users/akond/SECU_REPOS/ostk/ansi/windmill/playbooks/roles/test.prove/tasks/main.yaml,3,0,0,0,0,0,3
2019-03-08 12:54:53.481036,Users/akond/SECU_REPOS/ostk/ansi/bifrost/playbooks/roles/bifrost/ironic/install/defaults/required_defaults_Debian_family.yml,1,0,0,0,0,0,1
2019-03-08 12:54:53.481038,Users/akond/SECU_REPOS/ostk/ansi/bifrost/playbooks/roles/bifrost/ironic/install/defaults/required_defaults_Debian_jessie.yml,1,0,0,0,0,0,1
2019-03-08 12:54:53.481043,Users/akond/SECU_REPOS/ostk/ansi/bifrost/playbooks/roles/bifrost/ironic/install/defaults/required_defaults_Fedora_25.yml,1,0,0,0,0,0,1
2019-03-08 12:54:53.481045,Users/akond/SECU_REPOS/ostk/ansi/bifrost/playbooks/roles/bifrost/ironic/install/defaults/required_defaults_Fedora_26.yml,1,0,0,0,0,0,1
2019-03-08 12:54:53.481048,Users/akond/SECU_REPOS/ostk/ansi/bifrost/playbooks/roles/bifrost/ironic/install/defaults/required_defaults_Fedora_27.yml,1,0,0,0,0,0,1
2019-03-08 12:54:53.481050,Users/akond/SECU_REPOS/ostk/ansi/bifrost/playbooks/roles/bifrost/ironic/install/defaults/required_defaults_openSUSE_Leap_15.0.yml,1,0,0,0,0,0,1
2019-03-08 12:54:53.481075,Users/akond/SECU_REPOS/ostk/ansi/openstack/ansible/playbooks/defaults/healthchecks/vars.yml,2,0,2,3,0,0,7
2019-03-08 12:54:53.481106,Users/akond/SECU_REPOS/ostk/ansi/openstack/ansible/ops/leap/upgrades/upgrade/utilities/newton/playbooks/ansible_fact_cleanup/newton.yml,1,0,0,0,0,0,1
2019-03-08 12:54:53.481108,Users/akond/SECU_REPOS/ostk/ansi/openstack/ansible/ops/leap/upgrades/upgrade/utilities/newton/playbooks/aodh/api/init/delete.yml,1,0,0,0,0,0,1
2019-03-08 12:54:53.481111,Users/akond/SECU_REPOS/ostk/ansi/openstack/ansible/ops/leap/upgrades/upgrade/utilities/newton/playbooks/ceilometer/api/init/delete.yml,1,0,0,0,0,0,1
2019-03-08 12:54:53.481113,Users/akond/SECU_REPOS/ostk/ansi/openstack/ansible/ops/leap/upgrades/upgrade/utilities/newton/playbooks/deploy/config/changes/newton.yml,1,0,0,0,0,0,1
2019-03-08 12:54:53.481115,Users/akond/SECU_REPOS/ostk/ansi/openstack/ansible/ops/leap/upgrades/upgrade/utilities/newton/playbooks/galera/cluster/rolling/restart.yml,1,0,0,0,0,0,1
